"","year","age","region","female","male","all"
"1",2013,0,"England",331752,349921,681673
"2",2013,1,"England",344583,361876,706459
"3",2013,2,"England",338426,355605,694031
"4",2013,3,"England",333750,349649,683399
"5",2013,4,"England",329688,345052,674740
"6",2013,5,"England",332375,349098,681473
"7",2013,6,"England",321564,338070,659634
"8",2013,7,"England",315641,330544,646185
"9",2013,8,"England",302377,316503,618880
"10",2013,9,"England",296919,310969,607888
"11",2013,10,"England",287540,302475,590015
"12",2013,11,"England",282630,296580,579210
"13",2013,12,"England",290841,303248,594089
"14",2013,13,"England",297421,312349,609770
"15",2013,14,"England",306588,321938,628526
"16",2013,15,"England",310103,325992,636095
"17",2013,16,"England",318586,334775,653361
"18",2013,17,"England",317050,337741,654791
"19",2013,18,"England",319259,336378,655637
"20",2013,19,"England",331869,349099,680968
"21",2013,20,"England",338082,351437,689519
"22",2013,21,"England",354547,362841,717388
"23",2013,22,"England",364592,378975,743567
"24",2013,23,"England",362992,377548,740540
"25",2013,24,"England",365896,370823,736719
"26",2013,25,"England",373884,374187,748071
"27",2013,26,"England",370059,364124,734183
"28",2013,27,"England",371289,373115,744404
"29",2013,28,"England",373482,375385,748867
"30",2013,29,"England",368415,366324,734739
"31",2013,30,"England",373334,368866,742200
"32",2013,31,"England",374203,368482,742685
"33",2013,32,"England",376983,372638,749621
"34",2013,33,"England",377483,373841,751324
"35",2013,34,"England",361094,360265,721359
"36",2013,35,"England",335969,336763,672732
"37",2013,36,"England",330785,331577,662362
"38",2013,37,"England",337756,335550,673306
"39",2013,38,"England",344716,342380,687096
"40",2013,39,"England",351471,347354,698825
"41",2013,40,"England",366285,362997,729282
"42",2013,41,"England",381705,377498,759203
"43",2013,42,"England",396713,386931,783644
"44",2013,43,"England",386618,378030,764648
"45",2013,44,"England",396245,386402,782647
"46",2013,45,"England",395698,386341,782039
"47",2013,46,"England",399908,393383,793291
"48",2013,47,"England",402292,391487,793779
"49",2013,48,"England",404019,393399,797418
"50",2013,49,"England",399854,390154,790008
"51",2013,50,"England",391111,382554,773665
"52",2013,51,"England",381611,375030,756641
"53",2013,52,"England",367892,362264,730156
"54",2013,53,"England",353403,347607,701010
"55",2013,54,"England",345395,339971,685366
"56",2013,55,"England",337739,332311,670050
"57",2013,56,"England",325776,319271,645047
"58",2013,57,"England",314261,308450,622711
"59",2013,58,"England",303973,296206,600179
"60",2013,59,"England",305876,296154,602030
"61",2013,60,"England",301715,293049,594764
"62",2013,61,"England",294858,283672,578530
"63",2013,62,"England",297346,285467,582813
"64",2013,63,"England",305099,290447,595546
"65",2013,64,"England",312434,298809,611243
"66",2013,65,"England",330928,314965,645893
"67",2013,66,"England",358843,342788,701631
"68",2013,67,"England",278279,263607,541886
"69",2013,68,"England",271080,254973,526053
"70",2013,69,"England",270273,253733,524006
"71",2013,70,"England",252968,234145,487113
"72",2013,71,"England",227555,207266,434821
"73",2013,72,"England",206190,184774,390964
"74",2013,73,"England",214858,191661,406519
"75",2013,74,"England",214268,189075,403343
"76",2013,75,"England",208448,183024,391472
"77",2013,76,"England",199405,171686,371091
"78",2013,77,"England",190930,161179,352109
"79",2013,78,"England",182448,151172,333620
"80",2013,79,"England",170459,137669,308128
"81",2013,80,"England",163761,128345,292106
"82",2013,81,"England",160537,122285,282822
"83",2013,82,"England",154536,112517,267053
"84",2013,83,"England",145628,101190,246818
"85",2013,84,"England",132125,88570,220695
"86",2013,85,"England",119789,76850,196639
"87",2013,86,"England",109583,68275,177858
"88",2013,87,"England",100235,58806,159041
"89",2013,88,"England",89589,49185,138774
"90",2013,89,"England",79604,40673,120277
"91",2013,90,"England",61020,27470,88490
"92",2014,0,"England",326253,342966,669219
"93",2014,1,"England",334898,353041,687939
"94",2014,2,"England",347589,364731,712320
"95",2014,3,"England",341103,358324,699427
"96",2014,4,"England",336120,352174,688294
"97",2014,5,"England",331891,347406,679297
"98",2014,6,"England",334200,350899,685099
"99",2014,7,"England",323263,339888,663151
"100",2014,8,"England",317211,332230,649441
"101",2014,9,"England",303896,318107,622003
"102",2014,10,"England",298511,312461,610972
"103",2014,11,"England",289217,304067,593284
"104",2014,12,"England",284478,298296,582774
"105",2014,13,"England",292602,305044,597646
"106",2014,14,"England",299055,314402,613457
"107",2014,15,"England",308313,324132,632445
"108",2014,16,"England",312060,328162,640222
"109",2014,17,"England",320882,337921,658803
"110",2014,18,"England",319997,341101,661098
"111",2014,19,"England",323675,340717,664392
"112",2014,20,"England",337826,355179,693005
"113",2014,21,"England",343066,357969,701035
"114",2014,22,"England",361374,369270,730644
"115",2014,23,"England",371114,385292,756406
"116",2014,24,"England",367467,381908,749375
"117",2014,25,"England",369572,375072,744644
"118",2014,26,"England",377185,378015,755200
"119",2014,27,"England",373106,367009,740115
"120",2014,28,"England",373690,375689,749379
"121",2014,29,"England",375971,377974,753945
"122",2014,30,"England",370169,367983,738152
"123",2014,31,"England",374387,370720,745107
"124",2014,32,"England",375190,369757,744947
"125",2014,33,"England",377820,373575,751395
"126",2014,34,"England",378252,374807,753059
"127",2014,35,"England",361924,360416,722340
"128",2014,36,"England",336832,336862,673694
"129",2014,37,"England",331621,331547,663168
"130",2014,38,"England",338481,335847,674328
"131",2014,39,"England",345275,342240,687515
"132",2014,40,"England",352084,347176,699260
"133",2014,41,"England",366474,362809,729283
"134",2014,42,"England",382051,377388,759439
"135",2014,43,"England",396709,386893,783602
"136",2014,44,"England",386599,378098,764697
"137",2014,45,"England",396316,386391,782707
"138",2014,46,"England",395821,386206,782027
"139",2014,47,"England",399995,393244,793239
"140",2014,48,"England",402412,391115,793527
"141",2014,49,"England",404237,393155,797392
"142",2014,50,"England",399840,389773,789613
"143",2014,51,"England",390971,381849,772820
"144",2014,52,"England",381309,374470,755779
"145",2014,53,"England",367539,361627,729166
"146",2014,54,"England",352850,346840,699690
"147",2014,55,"England",344774,338862,683636
"148",2014,56,"England",337147,331122,668269
"149",2014,57,"England",325143,317949,643092
"150",2014,58,"England",313508,306817,620325
"151",2014,59,"England",303221,294506,597727
"152",2014,60,"England",304915,294103,599018
"153",2014,61,"England",300683,291053,591736
"154",2014,62,"England",293888,281369,575257
"155",2014,63,"England",296187,283359,579546
"156",2014,64,"England",303835,287790,591625
"157",2014,65,"England",310631,295696,606327
"158",2014,66,"England",328722,311642,640364
"159",2014,67,"England",356283,338769,695052
"160",2014,68,"England",275996,259954,535950
"161",2014,69,"England",268602,250989,519591
"162",2014,70,"England",267344,249351,516695
"163",2014,71,"England",250098,229588,479686
"164",2014,72,"England",224421,202598,427019
"165",2014,73,"England",203041,180421,383462
"166",2014,74,"England",211155,186842,397997
"167",2014,75,"England",210156,183810,393966
"168",2014,76,"England",204100,177403,381503
"169",2014,77,"England",194662,165734,360396
"170",2014,78,"England",185978,154867,340845
"171",2014,79,"England",177040,144600,321640
"172",2014,80,"England",164679,130862,295541
"173",2014,81,"England",157355,121217,278572
"174",2014,82,"England",153345,114611,267956
"175",2014,83,"England",146607,104607,251214
"176",2014,84,"England",137311,93229,230540
"177",2014,85,"England",123468,80760,204228
"178",2014,86,"England",110922,69417,180339
"179",2014,87,"England",100267,60801,161068
"180",2014,88,"England",90744,51515,142259
"181",2014,89,"England",80024,42450,122474
"182",2014,90,"England",60310,27910,88220
"183",2015,0,"England",325291,342748,668039
"184",2015,1,"England",329535,346565,676100
"185",2015,2,"England",338076,356089,694165
"186",2015,3,"England",350410,367540,717950
"187",2015,4,"England",343699,360831,704530
"188",2015,5,"England",338489,354480,692969
"189",2015,6,"England",333747,349339,683086
"190",2015,7,"England",336004,352858,688862
"191",2015,8,"England",324837,341775,666612
"192",2015,9,"England",318740,333978,652718
"193",2015,10,"England",305428,319944,625372
"194",2015,11,"England",300318,314514,614832
"195",2015,12,"England",291081,305970,597051
"196",2015,13,"England",286308,300250,586558
"197",2015,14,"England",294349,307262,601611
"198",2015,15,"England",300900,316961,617861
"199",2015,16,"England",310156,326772,636928
"200",2015,17,"England",314737,331730,646467
"201",2015,18,"England",324429,342014,666443
"202",2015,19,"England",325065,346159,671224
"203",2015,20,"England",330296,348014,678310
"204",2015,21,"England",343635,362592,706227
"205",2015,22,"England",351047,365950,716997
"206",2015,23,"England",369328,376620,745948
"207",2015,24,"England",377228,391480,768708
"208",2015,25,"England",372316,387385,759701
"209",2015,26,"England",374270,379847,754117
"210",2015,27,"England",381767,382554,764321
"211",2015,28,"England",377015,370581,747596
"212",2015,29,"England",377445,379765,757210
"213",2015,30,"England",378850,380478,759328
"214",2015,31,"England",371999,370864,742863
"215",2015,32,"England",376233,372953,749186
"216",2015,33,"England",376855,371092,747947
"217",2015,34,"England",378994,374890,753884
"218",2015,35,"England",379406,375899,755305
"219",2015,36,"England",363319,361121,724440
"220",2015,37,"England",338117,337502,675619
"221",2015,38,"England",332713,332260,664973
"222",2015,39,"England",339602,336137,675739
"223",2015,40,"England",346511,342667,689178
"224",2015,41,"England",352695,347287,699982
"225",2015,42,"England",367145,363311,730456
"226",2015,43,"England",382509,377921,760430
"227",2015,44,"England",397087,387619,784706
"228",2015,45,"England",386956,378696,765652
"229",2015,46,"England",396731,386746,783477
"230",2015,47,"England",396222,386521,782743
"231",2015,48,"England",400418,393361,793779
"232",2015,49,"England",402716,391166,793882
"233",2015,50,"England",404255,392939,797194
"234",2015,51,"England",399987,389428,789415
"235",2015,52,"England",390646,381337,771983
"236",2015,53,"England",380935,373707,754642
"237",2015,54,"England",367030,360829,727859
"238",2015,55,"England",352264,345811,698075
"239",2015,56,"England",344214,337548,681762
"240",2015,57,"England",336512,329949,666461
"241",2015,58,"England",324445,316545,640990
"242",2015,59,"England",312861,305173,618034
"243",2015,60,"England",302396,292918,595314
"244",2015,61,"England",304039,292292,596331
"245",2015,62,"England",299668,289096,588764
"246",2015,63,"England",292817,279274,572091
"247",2015,64,"England",294962,280817,575779
"248",2015,65,"England",302261,284777,587038
"249",2015,66,"England",308376,292412,600788
"250",2015,67,"England",326351,307789,634140
"251",2015,68,"England",353280,334295,687575
"252",2015,69,"England",273436,256165,529601
"253",2015,70,"England",265639,246824,512463
"254",2015,71,"England",264111,244716,508827
"255",2015,72,"England",246732,224674,471406
"256",2015,73,"England",221019,197924,418943
"257",2015,74,"England",199485,175621,375106
"258",2015,75,"England",207054,181373,388427
"259",2015,76,"England",205490,177852,383342
"260",2015,77,"England",198925,170947,369872
"261",2015,78,"England",189195,159058,348253
"262",2015,79,"England",180139,147815,327954
"263",2015,80,"England",170442,137118,307560
"264",2015,81,"England",157731,123300,281031
"265",2015,82,"England",149838,113267,263105
"266",2015,83,"England",144938,105954,250892
"267",2015,84,"England",137273,95898,233171
"268",2015,85,"England",127557,84415,211972
"269",2015,86,"England",113421,72202,185623
"270",2015,87,"England",100720,61090,161810
"271",2015,88,"England",89665,52759,142424
"272",2015,89,"England",79960,43902,123862
"273",2015,90,"England",58830,28170,87000
"274",2016,0,"England",328302,345789,674091
"275",2016,1,"England",328734,346245,674979
"276",2016,2,"England",332893,349785,682678
"277",2016,3,"England",341043,359047,700090
"278",2016,4,"England",353160,370139,723299
"279",2016,5,"England",346107,363040,709147
"280",2016,6,"England",340391,356543,696934
"281",2016,7,"England",335474,351373,686847
"282",2016,8,"England",337638,354739,692377
"283",2016,9,"England",326366,343776,670142
"284",2016,10,"England",320291,336063,656354
"285",2016,11,"England",307195,322005,629200
"286",2016,12,"England",302216,316614,618830
"287",2016,13,"England",292896,307979,600875
"288",2016,14,"England",287857,302617,590474
"289",2016,15,"England",296292,310179,606471
"290",2016,16,"England",302960,319959,622919
"291",2016,17,"England",312944,330883,643827
"292",2016,18,"England",318189,335979,654168
"293",2016,19,"England",329476,347783,677259
"294",2016,20,"England",331117,353548,684665
"295",2016,21,"England",334971,355416,690387
"296",2016,22,"England",349900,370418,720318
"297",2016,23,"England",357413,373763,731176
"298",2016,24,"England",374154,383159,757313
"299",2016,25,"England",380991,397394,778385
"300",2016,26,"England",376088,392578,768666
"301",2016,27,"England",377542,384821,762363
"302",2016,28,"England",384999,387045,772044
"303",2016,29,"England",379915,375087,755002
"304",2016,30,"England",379633,382984,762617
"305",2016,31,"England",379909,383685,763594
"306",2016,32,"England",373324,373346,746670
"307",2016,33,"England",377171,374649,751820
"308",2016,34,"England",377514,372669,750183
"309",2016,35,"England",379531,376084,755615
"310",2016,36,"England",380397,376913,757310
"311",2016,37,"England",364292,362084,726376
"312",2016,38,"England",338651,338547,677198
"313",2016,39,"England",333343,332697,666040
"314",2016,40,"England",340681,336537,677218
"315",2016,41,"England",347210,342755,689965
"316",2016,42,"England",353910,347995,701905
"317",2016,43,"England",367881,363737,731618
"318",2016,44,"England",383211,378747,761958
"319",2016,45,"England",397666,388003,785669
"320",2016,46,"England",387531,379138,766669
"321",2016,47,"England",396939,386905,783844
"322",2016,48,"England",396318,386626,782944
"323",2016,49,"England",400459,393684,794143
"324",2016,50,"England",402555,391217,793772
"325",2016,51,"England",404134,392494,796628
"326",2016,52,"England",399504,389056,788560
"327",2016,53,"England",390260,380750,771010
"328",2016,54,"England",380437,372880,753317
"329",2016,55,"England",366350,359876,726226
"330",2016,56,"England",351693,344452,696145
"331",2016,57,"England",343507,336213,679720
"332",2016,58,"England",335826,328409,664235
"333",2016,59,"England",323725,315101,638826
"334",2016,60,"England",311970,303631,615601
"335",2016,61,"England",301451,291077,592528
"336",2016,62,"England",303018,290280,593298
"337",2016,63,"England",298537,286893,585430
"338",2016,64,"England",291474,276719,568193
"339",2016,65,"England",293206,277718,570924
"340",2016,66,"England",300092,281589,581681
"341",2016,67,"England",306160,288882,595042
"342",2016,68,"England",323660,303737,627397
"343",2016,69,"England",349882,329427,679309
"344",2016,70,"England",270460,251941,522401
"345",2016,71,"England",262435,242260,504695
"346",2016,72,"England",260653,239786,500439
"347",2016,73,"England",242947,219392,462339
"348",2016,74,"England",217167,192857,410024
"349",2016,75,"England",195611,170610,366221
"350",2016,76,"England",202604,175666,378270
"351",2016,77,"England",200467,171546,372013
"352",2016,78,"England",193571,164059,357630
"353",2016,79,"England",183537,152194,335731
"354",2016,80,"England",173944,140532,314476
"355",2016,81,"England",163746,129466,293212
"356",2016,82,"England",150575,115576,266151
"357",2016,83,"England",142098,105162,247260
"358",2016,84,"England",136338,97537,233875
"359",2016,85,"England",128039,87303,215342
"360",2016,86,"England",117738,75876,193614
"361",2016,87,"England",103540,64143,167683
"362",2016,88,"England",90683,53429,144112
"363",2016,89,"England",79729,45358,125087
"364",2016,90,"England",58710,29490,88200
"365",2017,0,"England",320927,337600,658527
"366",2017,1,"England",331226,348706,679932
"367",2017,2,"England",331357,348963,680320
"368",2017,3,"England",335269,352388,687657
"369",2017,4,"England",343381,361271,704652
"370",2017,5,"England",355136,372062,727198
"371",2017,6,"England",347804,364728,712532
"372",2017,7,"England",341831,358161,699992
"373",2017,8,"England",336850,352992,689842
"374",2017,9,"England",338913,356482,695395
"375",2017,10,"England",327709,345569,673278
"376",2017,11,"England",321758,337831,659589
"377",2017,12,"England",308940,323834,632774
"378",2017,13,"England",303747,318286,622033
"379",2017,14,"England",294383,310038,604421
"380",2017,15,"England",289582,304976,594558
"381",2017,16,"England",298125,312581,610706
"382",2017,17,"England",305274,323297,628571
"383",2017,18,"England",316353,334133,650486
"384",2017,19,"England",321793,339557,661350
"385",2017,20,"England",334716,352759,687475
"386",2017,21,"England",335216,358737,693953
"387",2017,22,"England",340999,360301,701300
"388",2017,23,"England",355375,374866,730241
"389",2017,24,"England",360797,375929,736726
"390",2017,25,"England",377059,385460,762519
"391",2017,26,"England",383688,398603,782291
"392",2017,27,"England",378384,393567,771951
"393",2017,28,"England",379730,385462,765192
"394",2017,29,"England",386948,388008,774956
"395",2017,30,"England",381271,374819,756090
"396",2017,31,"England",380629,382807,763436
"397",2017,32,"England",380958,383477,764435
"398",2017,33,"England",374649,372583,747232
"399",2017,34,"England",377977,373767,751744
"400",2017,35,"England",378288,372039,750327
"401",2017,36,"England",380466,375976,756442
"402",2017,37,"England",381083,376330,757413
"403",2017,38,"England",364557,362209,726766
"404",2017,39,"England",339070,338593,677663
"405",2017,40,"England",334109,332408,666517
"406",2017,41,"England",340990,336400,677390
"407",2017,42,"England",347791,343090,690881
"408",2017,43,"England",354118,348212,702330
"409",2017,44,"England",368096,364135,732231
"410",2017,45,"England",383385,378732,762117
"411",2017,46,"England",397789,387895,785684
"412",2017,47,"England",387507,378762,766269
"413",2017,48,"England",396891,386596,783487
"414",2017,49,"England",396332,386209,782541
"415",2017,50,"England",400184,393102,793286
"416",2017,51,"England",402420,390273,792693
"417",2017,52,"England",403616,391650,795266
"418",2017,53,"England",398938,388211,787149
"419",2017,54,"England",389569,379626,769195
"420",2017,55,"England",379557,371560,751117
"421",2017,56,"England",365588,358298,723886
"422",2017,57,"England",350898,342876,693774
"423",2017,58,"England",342735,334209,676944
"424",2017,59,"England",334973,326460,661433
"425",2017,60,"England",322655,313079,635734
"426",2017,61,"England",310750,301457,612207
"427",2017,62,"England",300368,288782,589150
"428",2017,63,"England",301546,287726,589272
"429",2017,64,"England",297081,284150,581231
"430",2017,65,"England",289612,273418,563030
"431",2017,66,"England",291059,274429,565488
"432",2017,67,"England",297770,277737,575507
"433",2017,68,"England",303626,284954,588580
"434",2017,69,"England",320687,299125,619812
"435",2017,70,"England",346224,323874,670098
"436",2017,71,"England",267368,247261,514629
"437",2017,72,"England",258813,237191,496004
"438",2017,73,"England",256663,234139,490802
"439",2017,74,"England",238860,213776,452636
"440",2017,75,"England",212898,187306,400204
"441",2017,76,"England",191337,165221,356558
"442",2017,77,"England",197498,169503,367001
"443",2017,78,"England",194848,164711,359559
"444",2017,79,"England",187546,156771,344317
"445",2017,80,"England",177091,144564,321655
"446",2017,81,"England",167046,132769,299815
"447",2017,82,"England",156283,121371,277654
"448",2017,83,"England",142848,107429,250277
"449",2017,84,"England",133628,96729,230357
"450",2017,85,"England",127021,88566,215587
"451",2017,86,"England",118147,78699,196846
"452",2017,87,"England",107308,67271,174579
"453",2017,88,"England",93240,55981,149221
"454",2017,89,"England",80352,45984,126336
"455",2017,90,"England",58810,30400,89210
"456",2018,0,"England",312980,329834,642814
"457",2018,1,"England",324093,341018,665111
"458",2018,2,"England",334301,351937,686238
"459",2018,3,"England",334240,351871,686111
"460",2018,4,"England",337602,354910,692512
"461",2018,5,"England",345338,363517,708855
"462",2018,6,"England",356933,373817,730750
"463",2018,7,"England",349338,366317,715655
"464",2018,8,"England",343578,359752,703330
"465",2018,9,"England",338279,354548,692827
"466",2018,10,"England",340691,358043,698734
"467",2018,11,"England",329245,347340,676585
"468",2018,12,"England",323576,339797,663373
"469",2018,13,"England",310673,325685,636358
"470",2018,14,"England",305490,320476,625966
"471",2018,15,"England",296181,312522,608703
"472",2018,16,"England",291361,307595,598956
"473",2018,17,"England",301289,315946,617235
"474",2018,18,"England",308361,327097,635458
"475",2018,19,"England",321477,339390,660867
"476",2018,20,"England",327566,346312,673878
"477",2018,21,"England",339271,359473,698744
"478",2018,22,"England",342720,365710,708430
"479",2018,23,"England",348084,367156,715240
"480",2018,24,"England",360329,379204,739533
"481",2018,25,"England",364423,379606,744029
"482",2018,26,"England",380110,387970,768080
"483",2018,27,"England",386198,399967,786165
"484",2018,28,"England",380330,394364,774694
"485",2018,29,"England",381426,386722,768148
"486",2018,30,"England",388190,388532,776722
"487",2018,31,"England",382463,375159,757622
"488",2018,32,"England",382092,383427,765519
"489",2018,33,"England",382274,383297,765571
"490",2018,34,"England",375889,371972,747861
"491",2018,35,"England",379181,373388,752569
"492",2018,36,"England",379306,371879,751185
"493",2018,37,"England",380901,375462,756363
"494",2018,38,"England",381228,375941,757169
"495",2018,39,"England",364627,362082,726709
"496",2018,40,"England",339403,338495,677898
"497",2018,41,"England",334198,332367,666565
"498",2018,42,"England",341544,336692,678236
"499",2018,43,"England",348091,342973,691064
"500",2018,44,"England",354180,348368,702548
"501",2018,45,"England",368475,363629,732104
"502",2018,46,"England",383601,378463,762064
"503",2018,47,"England",398025,387418,785443
"504",2018,48,"England",387866,378211,766077
"505",2018,49,"England",396971,386297,783268
"506",2018,50,"England",396246,385853,782099
"507",2018,51,"England",400001,392476,792477
"508",2018,52,"England",401934,389585,791519
"509",2018,53,"England",403007,391064,794071
"510",2018,54,"England",398362,387391,785753
"511",2018,55,"England",388822,378478,767300
"512",2018,56,"England",378851,369926,748777
"513",2018,57,"England",365015,356574,721589
"514",2018,58,"England",349979,340742,690721
"515",2018,59,"England",341791,331929,673720
"516",2018,60,"England",333982,324330,658312
"517",2018,61,"England",321400,310736,632136
"518",2018,62,"England",309280,299111,608391
"519",2018,63,"England",298928,286440,585368
"520",2018,64,"England",300282,285127,585409
"521",2018,65,"England",295006,281016,576022
"522",2018,66,"England",287443,270316,557759
"523",2018,67,"England",288932,270867,559799
"524",2018,68,"England",295284,274033,569317
"525",2018,69,"England",300937,280630,581567
"526",2018,70,"England",317371,294109,611480
"527",2018,71,"England",342231,317974,660205
"528",2018,72,"England",263796,242124,505920
"529",2018,73,"England",254950,231708,486658
"530",2018,74,"England",252317,228189,480506
"531",2018,75,"England",234199,207614,441813
"532",2018,76,"England",208250,181328,389578
"533",2018,77,"England",186366,159311,345677
"534",2018,78,"England",191969,162740,354709
"535",2018,79,"England",188611,157541,346152
"536",2018,80,"England",180856,148843,329699
"537",2018,81,"England",170009,136409,306418
"538",2018,82,"England",159300,124359,283659
"539",2018,83,"England",148228,112881,261109
"540",2018,84,"England",134343,98698,233041
"541",2018,85,"England",124512,88133,212645
"542",2018,86,"England",117007,79516,196523
"543",2018,87,"England",107631,69544,177175
"544",2018,88,"England",96360,58647,155007
"545",2018,89,"England",82437,47793,130230
"546",2018,90,"England",58600,31190,89790
"547",2019,0,"England",303111,320448,623559
"548",2019,1,"England",316093,333076,649169
"549",2019,2,"England",326984,343918,670902
"550",2019,3,"England",336732,354700,691432
"551",2019,4,"England",336230,354174,690404
"552",2019,5,"England",339477,357016,696493
"553",2019,6,"England",347033,365219,712252
"554",2019,7,"England",358199,375296,733495
"555",2019,8,"England",349920,367817,717737
"556",2019,9,"England",344530,361257,705787
"557",2019,10,"England",339213,356084,695297
"558",2019,11,"England",341641,359808,701449
"559",2019,12,"England",330432,348877,679309
"560",2019,13,"England",325002,341231,666233
"561",2019,14,"England",312034,327433,639467
"562",2019,15,"England",307061,322649,629710
"563",2019,16,"England",297701,314801,612502
"564",2019,17,"England",293431,310984,604415
"565",2019,18,"England",303973,319850,623823
"566",2019,19,"England",312333,331924,644257
"567",2019,20,"England",326824,345610,672434
"568",2019,21,"England",331358,352471,683829
"569",2019,22,"England",345874,365620,711494
"570",2019,23,"England",349210,371018,720228
"571",2019,24,"England",352718,370078,722796
"572",2019,25,"England",363634,382065,745699
"573",2019,26,"England",366882,380818,747700
"574",2019,27,"England",381790,388764,770554
"575",2019,28,"England",387223,400083,787306
"576",2019,29,"England",381275,394128,775403
"577",2019,30,"England",381637,386073,767710
"578",2019,31,"England",389191,387673,776864
"579",2019,32,"England",383380,374777,758157
"580",2019,33,"England",383058,382769,765827
"581",2019,34,"England",383206,382029,765235
"582",2019,35,"England",376661,370067,746728
"583",2019,36,"England",379924,372287,752211
"584",2019,37,"England",379589,370773,750362
"585",2019,38,"England",380745,374012,754757
"586",2019,39,"England",381361,375039,756400
"587",2019,40,"England",364859,361683,726542
"588",2019,41,"England",339143,338353,677496
"589",2019,42,"England",334364,332453,666817
"590",2019,43,"England",341443,336856,678299
"591",2019,44,"England",347597,343262,690859
"592",2019,45,"England",354012,348092,702104
"593",2019,46,"England",368379,363067,731446
"594",2019,47,"England",383373,377824,761197
"595",2019,48,"England",397944,386773,784717
"596",2019,49,"England",388016,377596,765612
"597",2019,50,"England",396883,385756,782639
"598",2019,51,"England",396149,385184,781333
"599",2019,52,"England",399646,391959,791605
"600",2019,53,"England",401237,388806,790043
"601",2019,54,"England",402156,390121,792277
"602",2019,55,"England",397395,386262,783657
"603",2019,56,"England",387826,376871,764697
"604",2019,57,"England",377667,368276,745943
"605",2019,58,"England",363849,354411,718260
"606",2019,59,"England",349085,338212,687297
"607",2019,60,"England",340464,329520,669984
"608",2019,61,"England",332482,321895,654377
"609",2019,62,"England",319874,308219,628093
"610",2019,63,"England",307637,296643,604280
"611",2019,64,"England",297312,283828,581140
"612",2019,65,"England",298212,282188,580400
"613",2019,66,"England",292972,277744,570716
"614",2019,67,"England",285226,266873,552099
"615",2019,68,"England",286470,267156,553626
"616",2019,69,"England",292300,269819,562119
"617",2019,70,"England",297694,276012,573706
"618",2019,71,"England",313550,288812,602362
"619",2019,72,"England",337685,311827,649512
"620",2019,73,"England",260027,236845,496872
"621",2019,74,"England",250804,226157,476961
"622",2019,75,"England",247664,222124,469788
"623",2019,76,"England",229430,201228,430658
"624",2019,77,"England",203478,175283,378761
"625",2019,78,"England",181440,153299,334739
"626",2019,79,"England",186284,155784,342068
"627",2019,80,"England",182292,149994,332286
"628",2019,81,"England",174036,141053,315089
"629",2019,82,"England",162726,128406,291132
"630",2019,83,"England",151454,116060,267514
"631",2019,84,"England",139975,104479,244454
"632",2019,85,"England",125990,90350,216340
"633",2019,86,"England",115535,79825,195360
"634",2019,87,"England",107500,71055,178555
"635",2019,88,"England",97597,61225,158822
"636",2019,89,"England",86036,50715,136751
"637",2019,90,"England",59500,32010,91510
"638",2020,0,"England",295328,311203,606531
"639",2020,1,"England",306405,323823,630228
"640",2020,2,"England",319227,336191,655418
"641",2020,3,"England",329581,346800,676381
"642",2020,4,"England",338957,357229,696186
"643",2020,5,"England",338299,356369,694668
"644",2020,6,"England",341332,358834,700166
"645",2020,7,"England",348647,366862,715509
"646",2020,8,"England",359193,376979,736172
"647",2020,9,"England",351186,369415,720601
"648",2020,10,"England",345744,362999,708743
"649",2020,11,"England",340468,358018,698486
"650",2020,12,"England",343056,361495,704551
"651",2020,13,"England",331845,350495,682340
"652",2020,14,"England",326315,343054,669369
"653",2020,15,"England",313383,329839,643222
"654",2020,16,"England",308274,324884,633158
"655",2020,17,"England",299935,318124,618059
"656",2020,18,"England",296275,315221,611496
"657",2020,19,"England",308702,325974,634676
"658",2020,20,"England",317459,339946,657405
"659",2020,21,"England",330666,353187,683853
"660",2020,22,"England",337855,360810,698665
"661",2020,23,"England",351896,373186,725082
"662",2020,24,"England",353708,376402,730110
"663",2020,25,"England",355648,374493,730141
"664",2020,26,"England",365829,385085,750914
"665",2020,27,"England",367913,384246,752159
"666",2020,28,"England",382524,391135,773659
"667",2020,29,"England",387687,402108,789795
"668",2020,30,"England",381563,395585,777148
"669",2020,31,"England",382493,387328,769821
"670",2020,32,"England",389812,388544,778356
"671",2020,33,"England",384001,375196,759197
"672",2020,34,"England",383286,382675,765961
"673",2020,35,"England",383046,381145,764191
"674",2020,36,"England",376559,369850,746409
"675",2020,37,"England",379406,371812,751218
"676",2020,38,"England",379217,369881,749098
"677",2020,39,"England",380741,373238,753979
"678",2020,40,"England",381079,374383,755462
"679",2020,41,"England",364389,361093,725482
"680",2020,42,"England",339163,338100,677263
"681",2020,43,"England",334060,332210,666270
"682",2020,44,"England",340772,337092,677864
"683",2020,45,"England",347386,343283,690669
"684",2020,46,"England",353877,347898,701775
"685",2020,47,"England",368000,362530,730530
"686",2020,48,"England",383162,377267,760429
"687",2020,49,"England",397912,386093,784005
"688",2020,50,"England",387838,376970,764808
"689",2020,51,"England",396690,385098,781788
"690",2020,52,"England",395585,384639,780224
"691",2020,53,"England",398900,391339,790239
"692",2020,54,"England",400511,387992,788503
"693",2020,55,"England",401384,389067,790451
"694",2020,56,"England",396480,384889,781369
"695",2020,57,"England",386797,375251,762048
"696",2020,58,"England",376711,366044,742755
"697",2020,59,"England",362811,352011,714822
"698",2020,60,"England",347830,335752,683582
"699",2020,61,"England",338942,326962,665904
"700",2020,62,"England",330891,319307,650198
"701",2020,63,"England",318273,305742,624015
"702",2020,64,"England",305849,293765,599614
"703",2020,65,"England",295253,280755,576008
"704",2020,66,"England",295999,278523,574522
"705",2020,67,"England",290638,273853,564491
"706",2020,68,"England",282636,262908,545544
"707",2020,69,"England",283524,262906,546430
"708",2020,70,"England",289220,265008,554228
"709",2020,71,"England",293994,270795,564789
"710",2020,72,"England",309356,282801,592157
"711",2020,73,"England",332753,304449,637202
"712",2020,74,"England",255459,230557,486016
"713",2020,75,"England",245985,219410,465395
"714",2020,76,"England",242253,214636,456889
"715",2020,77,"England",223490,193564,417054
"716",2020,78,"England",197442,167884,365326
"717",2020,79,"England",175359,145807,321166
"718",2020,80,"England",178974,147263,326237
"719",2020,81,"England",174531,140979,315510
"720",2020,82,"England",165628,131422,297050
"721",2020,83,"England",154153,118806,272959
"722",2020,84,"England",141988,106187,248175
"723",2020,85,"England",130149,94473,224622
"724",2020,86,"England",115764,80710,196474
"725",2020,87,"England",104842,70221,175063
"726",2020,88,"England",96288,61258,157546
"727",2020,89,"England",85949,51884,137833
"728",2020,90,"England",59940,32290,92230
"729",2013,91,"England",61540,27540,89080
"730",2013,92,"England",53790,22310,76100
"731",2013,93,"England",45540,17270,62810
"732",2013,94,"England",23570,8210,31780
"733",2013,95,"England",17650,5580,23230
"734",2013,96,"England",14670,4200,18870
"735",2013,97,"England",11440,3000,14440
"736",2013,98,"England",8590,2050,10640
"737",2013,99,"England",5820,1220,7040
"738",2013,100,"England",3880,740,4620
"739",2013,101,"England",2400,420,2820
"740",2013,102,"England",1390,260,1650
"741",2013,103,"England",820,110,930
"742",2013,104,"England",430,60,490
"743",2013,105,"England",520,70,590
"744",2014,91,"England",60820,27970,88790
"745",2014,92,"England",52390,22370,74760
"746",2014,93,"England",44840,17670,62510
"747",2014,94,"England",37270,13340,50610
"748",2014,95,"England",18760,6140,24900
"749",2014,96,"England",13620,4050,17670
"750",2014,97,"England",11130,2980,14110
"751",2014,98,"England",8400,2050,10450
"752",2014,99,"England",6220,1360,7580
"753",2014,100,"England",4040,800,4840
"754",2014,101,"England",2590,470,3060
"755",2014,102,"England",1520,250,1770
"756",2014,103,"England",880,150,1030
"757",2014,104,"England",500,60,560
"758",2014,105,"England",510,60,570
"759",2015,91,"England",59330,28230,87560
"760",2015,92,"England",50450,22190,72640
"761",2015,93,"England",42440,17300,59740
"762",2015,94,"England",35520,13210,48730
"763",2015,95,"England",28670,9810,38480
"764",2015,96,"England",13930,4270,18200
"765",2015,97,"England",9780,2750,12530
"766",2015,98,"England",7720,1910,9630
"767",2015,99,"England",5700,1250,6950
"768",2015,100,"England",3990,810,4800
"769",2015,101,"England",2550,460,3010
"770",2015,102,"England",1510,260,1770
"771",2015,103,"England",880,140,1020
"772",2015,104,"England",490,80,570
"773",2015,105,"England",500,60,560
"774",2016,91,"England",59260,29560,88820
"775",2016,92,"England",49930,22600,72530
"776",2016,93,"England",41550,17380,58930
"777",2016,94,"England",34340,13220,47560
"778",2016,95,"England",27970,9790,37760
"779",2016,96,"England",21870,7000,28870
"780",2016,97,"England",10310,2950,13260
"781",2016,98,"England",7060,1840,8900
"782",2016,99,"England",5330,1250,6580
"783",2016,100,"England",3850,780,4630
"784",2016,101,"England",2570,470,3040
"785",2016,102,"England",1610,260,1870
"786",2016,103,"England",910,130,1040
"787",2016,104,"England",520,70,590
"788",2016,105,"England",550,70,620
"789",2017,91,"England",59370,30460,89830
"790",2017,92,"England",49480,23640,73120
"791",2017,93,"England",40650,17610,58260
"792",2017,94,"England",33170,13150,46320
"793",2017,95,"England",26590,9590,36180
"794",2017,96,"England",20990,6960,27950
"795",2017,97,"England",16010,4860,20870
"796",2017,98,"England",7220,2000,9220
"797",2017,99,"England",4830,1160,5990
"798",2017,100,"England",3530,760,4290
"799",2017,101,"England",2450,440,2890
"800",2017,102,"England",1570,270,1840
"801",2017,103,"England",940,150,1090
"802",2017,104,"England",530,60,590
"803",2017,105,"England",560,60,620
"804",2018,91,"England",59170,31250,90420
"805",2018,92,"England",49370,24170,73540
"806",2018,93,"England",40000,18200,58200
"807",2018,94,"England",32180,13320,45500
"808",2018,95,"England",25470,9630,35100
"809",2018,96,"England",19870,6700,26570
"810",2018,97,"England",15150,4640,19790
"811",2018,98,"England",11130,3170,14300
"812",2018,99,"England",4860,1220,6080
"813",2018,100,"England",3150,700,3850
"814",2018,101,"England",2180,440,2620
"815",2018,102,"England",1400,240,1640
"816",2018,103,"England",880,140,1020
"817",2018,104,"England",490,90,580
"818",2018,105,"England",570,60,630
"819",2019,91,"England",60080,32080,92160
"820",2019,92,"England",50010,25360,75370
"821",2019,93,"England",40920,19080,60000
"822",2019,94,"England",32490,14080,46570
"823",2019,95,"England",25490,9890,35380
"824",2019,96,"England",19680,7030,26710
"825",2019,97,"England",14900,4680,19580
"826",2019,98,"England",11090,3190,14280
"827",2019,99,"England",7890,2130,10020
"828",2019,100,"England",3320,780,4100
"829",2019,101,"England",2110,430,2540
"830",2019,102,"England",1380,280,1660
"831",2019,103,"England",840,140,980
"832",2019,104,"England",520,70,590
"833",2019,105,"England",580,70,650
"834",2020,91,"England",60480,32350,92830
"835",2020,92,"England",49660,25050,74710
"836",2020,93,"England",40120,19140,59260
"837",2020,94,"England",32240,14030,46270
"838",2020,95,"England",24720,9950,34670
"839",2020,96,"England",18720,6790,25510
"840",2020,97,"England",14050,4640,18690
"841",2020,98,"England",10220,2960,13180
"842",2020,99,"England",7410,2000,9410
"843",2020,100,"England",5070,1240,6310
"844",2020,101,"England",2070,430,2500
"845",2020,102,"England",1250,230,1480
"846",2020,103,"England",780,140,920
"847",2020,104,"England",460,70,530
"848",2020,105,"England",540,60,600
"849",2013,0,"Scotland",28587,29821,58408
"850",2013,1,"Scotland",29315,30892,60207
"851",2013,2,"Scotland",30538,31856,62394
"852",2013,3,"Scotland",29246,30290,59536
"853",2013,4,"Scotland",29998,31135,61133
"854",2013,5,"Scotland",29886,30991,60877
"855",2013,6,"Scotland",28452,29935,58387
"856",2013,7,"Scotland",28148,29187,57335
"857",2013,8,"Scotland",27668,29157,56825
"858",2013,9,"Scotland",26955,28632,55587
"859",2013,10,"Scotland",26536,27504,54040
"860",2013,11,"Scotland",26270,27439,53709
"861",2013,12,"Scotland",27532,28420,55952
"862",2013,13,"Scotland",27821,29483,57304
"863",2013,14,"Scotland",29146,30543,59689
"864",2013,15,"Scotland",29649,31275,60924
"865",2013,16,"Scotland",30683,32409,63092
"866",2013,17,"Scotland",30267,32441,62708
"867",2013,18,"Scotland",31093,32922,64015
"868",2013,19,"Scotland",34352,34984,69336
"869",2013,20,"Scotland",36646,36451,73097
"870",2013,21,"Scotland",39345,38631,77976
"871",2013,22,"Scotland",39520,39449,78969
"872",2013,23,"Scotland",37734,37829,75563
"873",2013,24,"Scotland",37574,37369,74943
"874",2013,25,"Scotland",37978,37378,75356
"875",2013,26,"Scotland",36761,35803,72564
"876",2013,27,"Scotland",36320,35899,72219
"877",2013,28,"Scotland",36529,35299,71828
"878",2013,29,"Scotland",35172,33950,69122
"879",2013,30,"Scotland",36015,34347,70362
"880",2013,31,"Scotland",36534,34548,71082
"881",2013,32,"Scotland",36101,34872,70973
"882",2013,33,"Scotland",35469,34124,69593
"883",2013,34,"Scotland",33769,33178,66947
"884",2013,35,"Scotland",31893,30437,62330
"885",2013,36,"Scotland",30871,30403,61274
"886",2013,37,"Scotland",32913,31830,64743
"887",2013,38,"Scotland",33443,31846,65289
"888",2013,39,"Scotland",33731,32771,66502
"889",2013,40,"Scotland",35924,34648,70572
"890",2013,41,"Scotland",38707,36294,75001
"891",2013,42,"Scotland",40492,37638,78130
"892",2013,43,"Scotland",39784,37277,77061
"893",2013,44,"Scotland",41248,38675,79923
"894",2013,45,"Scotland",42166,39363,81529
"895",2013,46,"Scotland",41974,40205,82179
"896",2013,47,"Scotland",41949,39669,81618
"897",2013,48,"Scotland",43272,41243,84515
"898",2013,49,"Scotland",43218,40409,83627
"899",2013,50,"Scotland",42693,40361,83054
"900",2013,51,"Scotland",41468,40018,81486
"901",2013,52,"Scotland",40687,38915,79602
"902",2013,53,"Scotland",39081,37634,76715
"903",2013,54,"Scotland",39088,37092,76180
"904",2013,55,"Scotland",38149,36239,74388
"905",2013,56,"Scotland",36898,35480,72378
"906",2013,57,"Scotland",35748,34326,70074
"907",2013,58,"Scotland",34377,32751,67128
"908",2013,59,"Scotland",33825,32497,66322
"909",2013,60,"Scotland",33387,31861,65248
"910",2013,61,"Scotland",32205,30713,62918
"911",2013,62,"Scotland",32599,31067,63666
"912",2013,63,"Scotland",32551,31285,63836
"913",2013,64,"Scotland",33550,31938,65488
"914",2013,65,"Scotland",34714,32926,67640
"915",2013,66,"Scotland",37623,35306,72929
"916",2013,67,"Scotland",28460,26884,55344
"917",2013,68,"Scotland",27371,24975,52346
"918",2013,69,"Scotland",27573,25412,52985
"919",2013,70,"Scotland",27152,23774,50926
"920",2013,71,"Scotland",25156,21678,46834
"921",2013,72,"Scotland",23446,19820,43266
"922",2013,73,"Scotland",23787,20003,43790
"923",2013,74,"Scotland",23252,19330,42582
"924",2013,75,"Scotland",22706,18647,41353
"925",2013,76,"Scotland",21855,17106,38961
"926",2013,77,"Scotland",21123,16274,37397
"927",2013,78,"Scotland",20093,15227,35320
"928",2013,79,"Scotland",18678,13916,32594
"929",2013,80,"Scotland",17494,12663,30157
"930",2013,81,"Scotland",17258,11912,29170
"931",2013,82,"Scotland",15993,10774,26767
"932",2013,83,"Scotland",14732,9216,23948
"933",2013,84,"Scotland",13257,8134,21391
"934",2013,85,"Scotland",11742,6789,18531
"935",2013,86,"Scotland",10807,6002,16809
"936",2013,87,"Scotland",9804,5184,14988
"937",2013,88,"Scotland",8378,4283,12661
"938",2013,89,"Scotland",7419,3495,10914
"939",2013,90,"Scotland",5350,2320,7670
"940",2014,0,"Scotland",27993,29558,57551
"941",2014,1,"Scotland",28810,29969,58779
"942",2014,2,"Scotland",29470,31050,60520
"943",2014,3,"Scotland",30663,31948,62611
"944",2014,4,"Scotland",29400,30401,59801
"945",2014,5,"Scotland",30094,31215,61309
"946",2014,6,"Scotland",29990,31090,61080
"947",2014,7,"Scotland",28525,30007,58532
"948",2014,8,"Scotland",28212,29265,57477
"949",2014,9,"Scotland",27748,29252,57000
"950",2014,10,"Scotland",27026,28720,55746
"951",2014,11,"Scotland",26622,27547,54169
"952",2014,12,"Scotland",26310,27475,53785
"953",2014,13,"Scotland",27587,28503,56090
"954",2014,14,"Scotland",27930,29528,57458
"955",2014,15,"Scotland",29215,30624,59839
"956",2014,16,"Scotland",29706,31360,61066
"957",2014,17,"Scotland",30735,32430,63165
"958",2014,18,"Scotland",30690,32776,63466
"959",2014,19,"Scotland",33102,34402,67504
"960",2014,20,"Scotland",35657,35858,71515
"961",2014,21,"Scotland",37166,36756,73922
"962",2014,22,"Scotland",39842,38821,78663
"963",2014,23,"Scotland",39634,39493,79127
"964",2014,24,"Scotland",37682,37793,75475
"965",2014,25,"Scotland",37517,37355,74872
"966",2014,26,"Scotland",38031,37324,75355
"967",2014,27,"Scotland",36887,35895,72782
"968",2014,28,"Scotland",36365,35803,72168
"969",2014,29,"Scotland",36700,35173,71873
"970",2014,30,"Scotland",35415,34012,69427
"971",2014,31,"Scotland",36081,34417,70498
"972",2014,32,"Scotland",36693,34570,71263
"973",2014,33,"Scotland",36221,34825,71046
"974",2014,34,"Scotland",35588,34139,69727
"975",2014,35,"Scotland",33886,33215,67101
"976",2014,36,"Scotland",31978,30448,62426
"977",2014,37,"Scotland",30881,30491,61372
"978",2014,38,"Scotland",32979,31821,64800
"979",2014,39,"Scotland",33497,31919,65416
"980",2014,40,"Scotland",33765,32723,66488
"981",2014,41,"Scotland",35984,34610,70594
"982",2014,42,"Scotland",38749,36336,75085
"983",2014,43,"Scotland",40557,37602,78159
"984",2014,44,"Scotland",39760,37206,76966
"985",2014,45,"Scotland",41307,38647,79954
"986",2014,46,"Scotland",42121,39288,81409
"987",2014,47,"Scotland",41971,40102,82073
"988",2014,48,"Scotland",41956,39533,81489
"989",2014,49,"Scotland",43245,41134,84379
"990",2014,50,"Scotland",43177,40313,83490
"991",2014,51,"Scotland",42645,40286,82931
"992",2014,52,"Scotland",41420,39875,81295
"993",2014,53,"Scotland",40561,38770,79331
"994",2014,54,"Scotland",38987,37517,76504
"995",2014,55,"Scotland",39072,36931,76003
"996",2014,56,"Scotland",38004,36085,74089
"997",2014,57,"Scotland",36711,35333,72044
"998",2014,58,"Scotland",35607,34081,69688
"999",2014,59,"Scotland",34237,32470,66707
"1000",2014,60,"Scotland",33649,32256,65905
"1001",2014,61,"Scotland",33223,31592,64815
"1002",2014,62,"Scotland",31969,30434,62403
"1003",2014,63,"Scotland",32363,30666,63029
"1004",2014,64,"Scotland",32335,30937,63272
"1005",2014,65,"Scotland",33233,31533,64766
"1006",2014,66,"Scotland",34376,32399,66775
"1007",2014,67,"Scotland",37214,34743,71957
"1008",2014,68,"Scotland",28151,26387,54538
"1009",2014,69,"Scotland",26994,24446,51440
"1010",2014,70,"Scotland",27166,24844,52010
"1011",2014,71,"Scotland",26642,23167,49809
"1012",2014,72,"Scotland",24697,21021,45718
"1013",2014,73,"Scotland",22974,19161,42135
"1014",2014,74,"Scotland",23263,19316,42579
"1015",2014,75,"Scotland",22662,18607,41269
"1016",2014,76,"Scotland",22063,17921,39984
"1017",2014,77,"Scotland",21204,16340,37544
"1018",2014,78,"Scotland",20379,15470,35849
"1019",2014,79,"Scotland",19251,14408,33659
"1020",2014,80,"Scotland",17873,13055,30928
"1021",2014,81,"Scotland",16660,11870,28530
"1022",2014,82,"Scotland",16290,11063,27353
"1023",2014,83,"Scotland",15010,9823,24833
"1024",2014,84,"Scotland",13656,8406,22062
"1025",2014,85,"Scotland",12206,7272,19478
"1026",2014,86,"Scotland",10745,6046,16791
"1027",2014,87,"Scotland",9757,5290,15047
"1028",2014,88,"Scotland",8779,4502,13281
"1029",2014,89,"Scotland",7318,3666,10984
"1030",2014,90,"Scotland",5240,2230,7470
"1031",2015,0,"Scotland",27897,29556,57453
"1032",2015,1,"Scotland",28237,29815,58052
"1033",2015,2,"Scotland",28993,30206,59199
"1034",2015,3,"Scotland",29611,31224,60835
"1035",2015,4,"Scotland",30823,32088,62911
"1036",2015,5,"Scotland",29481,30530,60011
"1037",2015,6,"Scotland",30209,31318,61527
"1038",2015,7,"Scotland",30093,31159,61252
"1039",2015,8,"Scotland",28661,30134,58795
"1040",2015,9,"Scotland",28293,29355,57648
"1041",2015,10,"Scotland",27837,29370,57207
"1042",2015,11,"Scotland",27116,28782,55898
"1043",2015,12,"Scotland",26673,27638,54311
"1044",2015,13,"Scotland",26381,27580,53961
"1045",2015,14,"Scotland",27688,28637,56325
"1046",2015,15,"Scotland",28018,29663,57681
"1047",2015,16,"Scotland",29294,30744,60038
"1048",2015,17,"Scotland",29823,31484,61307
"1049",2015,18,"Scotland",31268,32813,64081
"1050",2015,19,"Scotland",33018,34424,67442
"1051",2015,20,"Scotland",34663,35515,70178
"1052",2015,21,"Scotland",36618,36547,73165
"1053",2015,22,"Scotland",37845,37267,75112
"1054",2015,23,"Scotland",40228,39317,79545
"1055",2015,24,"Scotland",39866,39672,79538
"1056",2015,25,"Scotland",38098,38172,76270
"1057",2015,26,"Scotland",37883,37680,75563
"1058",2015,27,"Scotland",38257,37611,75868
"1059",2015,28,"Scotland",37151,36176,73327
"1060",2015,29,"Scotland",36686,36027,72713
"1061",2015,30,"Scotland",36929,35426,72355
"1062",2015,31,"Scotland",35595,34278,69873
"1063",2015,32,"Scotland",36281,34624,70905
"1064",2015,33,"Scotland",36896,34741,71637
"1065",2015,34,"Scotland",36434,34998,71432
"1066",2015,35,"Scotland",35699,34326,70025
"1067",2015,36,"Scotland",34068,33437,67505
"1068",2015,37,"Scotland",32142,30542,62684
"1069",2015,38,"Scotland",31039,30612,61651
"1070",2015,39,"Scotland",33096,31922,65018
"1071",2015,40,"Scotland",33562,31943,65505
"1072",2015,41,"Scotland",33780,32703,66483
"1073",2015,42,"Scotland",36001,34625,70626
"1074",2015,43,"Scotland",38775,36354,75129
"1075",2015,44,"Scotland",40576,37582,78158
"1076",2015,45,"Scotland",39765,37159,76924
"1077",2015,46,"Scotland",41308,38576,79884
"1078",2015,47,"Scotland",42099,39221,81320
"1079",2015,48,"Scotland",41905,40018,81923
"1080",2015,49,"Scotland",41934,39471,81405
"1081",2015,50,"Scotland",43242,41018,84260
"1082",2015,51,"Scotland",43117,40197,83314
"1083",2015,52,"Scotland",42538,40111,82649
"1084",2015,53,"Scotland",41322,39714,81036
"1085",2015,54,"Scotland",40508,38673,79181
"1086",2015,55,"Scotland",38924,37343,76267
"1087",2015,56,"Scotland",38947,36721,75668
"1088",2015,57,"Scotland",37902,35921,73823
"1089",2015,58,"Scotland",36569,35072,71641
"1090",2015,59,"Scotland",35472,33858,69330
"1091",2015,60,"Scotland",34096,32221,66317
"1092",2015,61,"Scotland",33472,31963,65435
"1093",2015,62,"Scotland",33038,31276,64314
"1094",2015,63,"Scotland",31763,30121,61884
"1095",2015,64,"Scotland",32109,30320,62429
"1096",2015,65,"Scotland",32069,30464,62533
"1097",2015,66,"Scotland",32903,31019,63922
"1098",2015,67,"Scotland",34017,31885,65902
"1099",2015,68,"Scotland",36773,34117,70890
"1100",2015,69,"Scotland",27741,25759,53500
"1101",2015,70,"Scotland",26531,23863,50394
"1102",2015,71,"Scotland",26709,24239,50948
"1103",2015,72,"Scotland",26075,22449,48524
"1104",2015,73,"Scotland",24141,20335,44476
"1105",2015,74,"Scotland",22440,18469,40909
"1106",2015,75,"Scotland",22624,18577,41201
"1107",2015,76,"Scotland",22020,17793,39813
"1108",2015,77,"Scotland",21326,17090,38416
"1109",2015,78,"Scotland",20372,15464,35836
"1110",2015,79,"Scotland",19522,14597,34119
"1111",2015,80,"Scotland",18301,13543,31844
"1112",2015,81,"Scotland",17023,12174,29197
"1113",2015,82,"Scotland",15691,11018,26709
"1114",2015,83,"Scotland",15147,10122,25269
"1115",2015,84,"Scotland",13883,8825,22708
"1116",2015,85,"Scotland",12514,7454,19968
"1117",2015,86,"Scotland",11067,6434,17501
"1118",2015,87,"Scotland",9598,5194,14792
"1119",2015,88,"Scotland",8580,4454,13034
"1120",2015,89,"Scotland",7618,3768,11386
"1121",2015,90,"Scotland",5250,2370,7620
"1122",2016,0,"Scotland",27562,29411,56973
"1123",2016,1,"Scotland",28224,29787,58011
"1124",2016,2,"Scotland",28458,30057,58515
"1125",2016,3,"Scotland",29187,30414,59601
"1126",2016,4,"Scotland",29789,31421,61210
"1127",2016,5,"Scotland",30995,32270,63265
"1128",2016,6,"Scotland",29628,30677,60305
"1129",2016,7,"Scotland",30370,31471,61841
"1130",2016,8,"Scotland",30241,31288,61529
"1131",2016,9,"Scotland",28791,30279,59070
"1132",2016,10,"Scotland",28415,29496,57911
"1133",2016,11,"Scotland",27933,29462,57395
"1134",2016,12,"Scotland",27197,28916,56113
"1135",2016,13,"Scotland",26778,27765,54543
"1136",2016,14,"Scotland",26489,27687,54176
"1137",2016,15,"Scotland",27789,28812,56601
"1138",2016,16,"Scotland",28137,29828,57965
"1139",2016,17,"Scotland",29412,30850,60262
"1140",2016,18,"Scotland",30419,31928,62347
"1141",2016,19,"Scotland",33523,34578,68101
"1142",2016,20,"Scotland",34604,35523,70127
"1143",2016,21,"Scotland",35725,36158,71883
"1144",2016,22,"Scotland",37234,37127,74361
"1145",2016,23,"Scotland",38467,37879,76346
"1146",2016,24,"Scotland",40566,39784,80350
"1147",2016,25,"Scotland",40188,40216,80404
"1148",2016,26,"Scotland",38581,38545,77126
"1149",2016,27,"Scotland",38362,38132,76494
"1150",2016,28,"Scotland",38641,37880,76521
"1151",2016,29,"Scotland",37592,36556,74148
"1152",2016,30,"Scotland",36971,36346,73317
"1153",2016,31,"Scotland",37264,35651,72915
"1154",2016,32,"Scotland",35893,34577,70470
"1155",2016,33,"Scotland",36568,34834,71402
"1156",2016,34,"Scotland",37145,34964,72109
"1157",2016,35,"Scotland",36606,35169,71775
"1158",2016,36,"Scotland",35826,34526,70352
"1159",2016,37,"Scotland",34165,33631,67796
"1160",2016,38,"Scotland",32289,30745,63034
"1161",2016,39,"Scotland",31153,30848,62001
"1162",2016,40,"Scotland",33185,31975,65160
"1163",2016,41,"Scotland",33636,31945,65581
"1164",2016,42,"Scotland",33851,32752,66603
"1165",2016,43,"Scotland",36113,34675,70788
"1166",2016,44,"Scotland",38774,36344,75118
"1167",2016,45,"Scotland",40611,37566,78177
"1168",2016,46,"Scotland",39807,37084,76891
"1169",2016,47,"Scotland",41340,38591,79931
"1170",2016,48,"Scotland",42095,39183,81278
"1171",2016,49,"Scotland",41883,39953,81836
"1172",2016,50,"Scotland",41897,39346,81243
"1173",2016,51,"Scotland",43174,40945,84119
"1174",2016,52,"Scotland",43049,40112,83161
"1175",2016,53,"Scotland",42495,39963,82458
"1176",2016,54,"Scotland",41282,39587,80869
"1177",2016,55,"Scotland",40424,38516,78940
"1178",2016,56,"Scotland",38873,37211,76084
"1179",2016,57,"Scotland",38778,36541,75319
"1180",2016,58,"Scotland",37770,35660,73430
"1181",2016,59,"Scotland",36396,34823,71219
"1182",2016,60,"Scotland",35297,33596,68893
"1183",2016,61,"Scotland",33926,31957,65883
"1184",2016,62,"Scotland",33307,31682,64989
"1185",2016,63,"Scotland",32794,30878,63672
"1186",2016,64,"Scotland",31520,29772,61292
"1187",2016,65,"Scotland",31809,29937,61746
"1188",2016,66,"Scotland",31797,30017,61814
"1189",2016,67,"Scotland",32501,30542,63043
"1190",2016,68,"Scotland",33604,31283,64887
"1191",2016,69,"Scotland",36276,33429,69705
"1192",2016,70,"Scotland",27307,25126,52433
"1193",2016,71,"Scotland",26069,23264,49333
"1194",2016,72,"Scotland",26218,23561,49779
"1195",2016,73,"Scotland",25526,21713,47239
"1196",2016,74,"Scotland",23566,19653,43219
"1197",2016,75,"Scotland",21866,17764,39630
"1198",2016,76,"Scotland",21989,17823,39812
"1199",2016,77,"Scotland",21299,16974,38273
"1200",2016,78,"Scotland",20599,16248,36847
"1201",2016,79,"Scotland",19535,14593,34128
"1202",2016,80,"Scotland",18672,13664,32336
"1203",2016,81,"Scotland",17397,12605,30002
"1204",2016,82,"Scotland",16124,11279,27403
"1205",2016,83,"Scotland",14700,10118,24818
"1206",2016,84,"Scotland",14050,9189,23239
"1207",2016,85,"Scotland",12816,7936,20752
"1208",2016,86,"Scotland",11361,6598,17959
"1209",2016,87,"Scotland",9952,5627,15579
"1210",2016,88,"Scotland",8511,4470,12981
"1211",2016,89,"Scotland",7518,3792,11310
"1212",2016,90,"Scotland",5310,2480,7790
"1213",2017,0,"Scotland",26559,28420,54979
"1214",2017,1,"Scotland",27704,29612,57316
"1215",2017,2,"Scotland",28286,29950,58236
"1216",2017,3,"Scotland",28536,30154,58690
"1217",2017,4,"Scotland",29294,30570,59864
"1218",2017,5,"Scotland",29901,31554,61455
"1219",2017,6,"Scotland",31024,32392,63416
"1220",2017,7,"Scotland",29744,30766,60510
"1221",2017,8,"Scotland",30494,31617,62111
"1222",2017,9,"Scotland",30341,31423,61764
"1223",2017,10,"Scotland",28847,30430,59277
"1224",2017,11,"Scotland",28519,29606,58125
"1225",2017,12,"Scotland",28006,29569,57575
"1226",2017,13,"Scotland",27265,29018,56283
"1227",2017,14,"Scotland",26860,27911,54771
"1228",2017,15,"Scotland",26572,27764,54336
"1229",2017,16,"Scotland",27852,28907,56759
"1230",2017,17,"Scotland",28184,29945,58129
"1231",2017,18,"Scotland",29803,31257,61060
"1232",2017,19,"Scotland",32364,33550,65914
"1233",2017,20,"Scotland",34788,35730,70518
"1234",2017,21,"Scotland",35182,36115,71297
"1235",2017,22,"Scotland",35873,36520,72393
"1236",2017,23,"Scotland",37281,37465,74746
"1237",2017,24,"Scotland",38558,38047,76605
"1238",2017,25,"Scotland",40664,40023,80687
"1239",2017,26,"Scotland",40388,40445,80833
"1240",2017,27,"Scotland",38756,38799,77555
"1241",2017,28,"Scotland",38628,38334,76962
"1242",2017,29,"Scotland",38926,37935,76861
"1243",2017,30,"Scotland",37770,36725,74495
"1244",2017,31,"Scotland",37076,36619,73695
"1245",2017,32,"Scotland",37400,35796,73196
"1246",2017,33,"Scotland",36092,34651,70743
"1247",2017,34,"Scotland",36668,35070,71738
"1248",2017,35,"Scotland",37256,35131,72387
"1249",2017,36,"Scotland",36735,35316,72051
"1250",2017,37,"Scotland",35917,34696,70613
"1251",2017,38,"Scotland",34277,33816,68093
"1252",2017,39,"Scotland",32400,30919,63319
"1253",2017,40,"Scotland",31197,30915,62112
"1254",2017,41,"Scotland",33248,31926,65174
"1255",2017,42,"Scotland",33741,31914,65655
"1256",2017,43,"Scotland",33917,32798,66715
"1257",2017,44,"Scotland",36149,34703,70852
"1258",2017,45,"Scotland",38752,36320,75072
"1259",2017,46,"Scotland",40629,37449,78078
"1260",2017,47,"Scotland",39842,37021,76863
"1261",2017,48,"Scotland",41319,38507,79826
"1262",2017,49,"Scotland",42030,39077,81107
"1263",2017,50,"Scotland",41899,39911,81810
"1264",2017,51,"Scotland",41824,39282,81106
"1265",2017,52,"Scotland",43112,40835,83947
"1266",2017,53,"Scotland",42990,40007,82997
"1267",2017,54,"Scotland",42472,39878,82350
"1268",2017,55,"Scotland",41228,39391,80619
"1269",2017,56,"Scotland",40325,38340,78665
"1270",2017,57,"Scotland",38794,37064,75858
"1271",2017,58,"Scotland",38667,36353,75020
"1272",2017,59,"Scotland",37647,35492,73139
"1273",2017,60,"Scotland",36258,34551,70809
"1274",2017,61,"Scotland",35158,33336,68494
"1275",2017,62,"Scotland",33741,31628,65369
"1276",2017,63,"Scotland",33059,31358,64417
"1277",2017,64,"Scotland",32521,30524,63045
"1278",2017,65,"Scotland",31259,29419,60678
"1279",2017,66,"Scotland",31518,29441,60959
"1280",2017,67,"Scotland",31469,29544,61013
"1281",2017,68,"Scotland",32097,30041,62138
"1282",2017,69,"Scotland",33185,30627,63812
"1283",2017,70,"Scotland",35731,32730,68461
"1284",2017,71,"Scotland",26797,24529,51326
"1285",2017,72,"Scotland",25593,22656,48249
"1286",2017,73,"Scotland",25668,22870,48538
"1287",2017,74,"Scotland",24904,20978,45882
"1288",2017,75,"Scotland",22973,18926,41899
"1289",2017,76,"Scotland",21221,17020,38241
"1290",2017,77,"Scotland",21242,17058,38300
"1291",2017,78,"Scotland",20526,16185,36711
"1292",2017,79,"Scotland",19761,15377,35138
"1293",2017,80,"Scotland",18762,13727,32489
"1294",2017,81,"Scotland",17747,12740,30487
"1295",2017,82,"Scotland",16422,11695,28117
"1296",2017,83,"Scotland",15121,10304,25425
"1297",2017,84,"Scotland",13595,9212,22807
"1298",2017,85,"Scotland",12977,8257,21234
"1299",2017,86,"Scotland",11586,6996,18582
"1300",2017,87,"Scotland",10197,5758,15955
"1301",2017,88,"Scotland",8805,4866,13671
"1302",2017,89,"Scotland",7387,3762,11149
"1303",2017,90,"Scotland",5450,2620,8070
"1304",2018,0,"Scotland",26162,27503,53665
"1305",2018,1,"Scotland",26667,28545,55212
"1306",2018,2,"Scotland",27786,29737,57523
"1307",2018,3,"Scotland",28435,30081,58516
"1308",2018,4,"Scotland",28613,30270,58883
"1309",2018,5,"Scotland",29380,30671,60051
"1310",2018,6,"Scotland",30016,31690,61706
"1311",2018,7,"Scotland",31134,32461,63595
"1312",2018,8,"Scotland",29845,30850,60695
"1313",2018,9,"Scotland",30546,31736,62282
"1314",2018,10,"Scotland",30407,31508,61915
"1315",2018,11,"Scotland",28954,30503,59457
"1316",2018,12,"Scotland",28608,29725,58333
"1317",2018,13,"Scotland",28096,29669,57765
"1318",2018,14,"Scotland",27352,29071,56423
"1319",2018,15,"Scotland",26950,28012,54962
"1320",2018,16,"Scotland",26637,27885,54522
"1321",2018,17,"Scotland",27964,29041,57005
"1322",2018,18,"Scotland",28658,30479,59137
"1323",2018,19,"Scotland",32058,32977,65035
"1324",2018,20,"Scotland",33551,34706,68257
"1325",2018,21,"Scotland",35276,36268,71544
"1326",2018,22,"Scotland",35426,36552,71978
"1327",2018,23,"Scotland",35990,36857,72847
"1328",2018,24,"Scotland",37224,37585,74809
"1329",2018,25,"Scotland",38441,37950,76391
"1330",2018,26,"Scotland",40694,40081,80775
"1331",2018,27,"Scotland",40405,40478,80883
"1332",2018,28,"Scotland",38888,38965,77853
"1333",2018,29,"Scotland",38787,38348,77135
"1334",2018,30,"Scotland",39073,38165,77238
"1335",2018,31,"Scotland",37907,36809,74716
"1336",2018,32,"Scotland",37210,36734,73944
"1337",2018,33,"Scotland",37531,35935,73466
"1338",2018,34,"Scotland",36263,34764,71027
"1339",2018,35,"Scotland",36781,35175,71956
"1340",2018,36,"Scotland",37246,35314,72560
"1341",2018,37,"Scotland",36750,35359,72109
"1342",2018,38,"Scotland",36007,34802,70809
"1343",2018,39,"Scotland",34363,33945,68308
"1344",2018,40,"Scotland",32441,30917,63358
"1345",2018,41,"Scotland",31263,30882,62145
"1346",2018,42,"Scotland",33298,31901,65199
"1347",2018,43,"Scotland",33695,31869,65564
"1348",2018,44,"Scotland",33960,32741,66701
"1349",2018,45,"Scotland",36166,34664,70830
"1350",2018,46,"Scotland",38785,36205,74990
"1351",2018,47,"Scotland",40656,37389,78045
"1352",2018,48,"Scotland",39782,36914,76696
"1353",2018,49,"Scotland",41312,38396,79708
"1354",2018,50,"Scotland",42006,38962,80968
"1355",2018,51,"Scotland",41855,39825,81680
"1356",2018,52,"Scotland",41733,39164,80897
"1357",2018,53,"Scotland",43026,40698,83724
"1358",2018,54,"Scotland",42911,39865,82776
"1359",2018,55,"Scotland",42401,39720,82121
"1360",2018,56,"Scotland",41160,39204,80364
"1361",2018,57,"Scotland",40170,38131,78301
"1362",2018,58,"Scotland",38691,36805,75496
"1363",2018,59,"Scotland",38479,36071,74550
"1364",2018,60,"Scotland",37490,35240,72730
"1365",2018,61,"Scotland",36061,34258,70319
"1366",2018,62,"Scotland",34949,32992,67941
"1367",2018,63,"Scotland",33472,31264,64736
"1368",2018,64,"Scotland",32782,31043,63825
"1369",2018,65,"Scotland",32211,30144,62355
"1370",2018,66,"Scotland",30953,29015,59968
"1371",2018,67,"Scotland",31123,28951,60074
"1372",2018,68,"Scotland",31095,29068,60163
"1373",2018,69,"Scotland",31685,29441,61126
"1374",2018,70,"Scotland",32616,29967,62583
"1375",2018,71,"Scotland",35190,31958,67148
"1376",2018,72,"Scotland",26337,23832,50169
"1377",2018,73,"Scotland",25108,22024,47132
"1378",2018,74,"Scotland",25086,22107,47193
"1379",2018,75,"Scotland",24234,20226,44460
"1380",2018,76,"Scotland",22293,18084,40377
"1381",2018,77,"Scotland",20513,16250,36763
"1382",2018,78,"Scotland",20401,16182,36583
"1383",2018,79,"Scotland",19674,15245,34919
"1384",2018,80,"Scotland",18865,14395,33260
"1385",2018,81,"Scotland",17786,12737,30523
"1386",2018,82,"Scotland",16706,11766,28472
"1387",2018,83,"Scotland",15406,10733,26139
"1388",2018,84,"Scotland",14009,9297,23306
"1389",2018,85,"Scotland",12572,8251,20823
"1390",2018,86,"Scotland",11763,7338,19101
"1391",2018,87,"Scotland",10366,6137,16503
"1392",2018,88,"Scotland",8974,4924,13898
"1393",2018,89,"Scotland",7605,4079,11684
"1394",2018,90,"Scotland",5430,2600,8030
"1395",2019,0,"Scotland",25309,26853,52162
"1396",2019,1,"Scotland",26343,27716,54059
"1397",2019,2,"Scotland",26864,28778,55642
"1398",2019,3,"Scotland",28004,29964,57968
"1399",2019,4,"Scotland",28587,30259,58846
"1400",2019,5,"Scotland",28761,30389,59150
"1401",2019,6,"Scotland",29499,30866,60365
"1402",2019,7,"Scotland",30156,31853,62009
"1403",2019,8,"Scotland",31297,32617,63914
"1404",2019,9,"Scotland",29976,30994,60970
"1405",2019,10,"Scotland",30672,31899,62571
"1406",2019,11,"Scotland",30529,31666,62195
"1407",2019,12,"Scotland",29074,30656,59730
"1408",2019,13,"Scotland",28780,29915,58695
"1409",2019,14,"Scotland",28242,29828,58070
"1410",2019,15,"Scotland",27503,29246,56749
"1411",2019,16,"Scotland",27054,28197,55251
"1412",2019,17,"Scotland",26719,28060,54779
"1413",2019,18,"Scotland",28528,29525,58053
"1414",2019,19,"Scotland",30760,32152,62912
"1415",2019,20,"Scotland",33278,34141,67419
"1416",2019,21,"Scotland",34249,35323,69572
"1417",2019,22,"Scotland",35954,36861,72815
"1418",2019,23,"Scotland",35964,37159,73123
"1419",2019,24,"Scotland",36173,37146,73319
"1420",2019,25,"Scotland",37215,37776,74991
"1421",2019,26,"Scotland",38582,38260,76842
"1422",2019,27,"Scotland",40864,40396,81260
"1423",2019,28,"Scotland",40598,40826,81424
"1424",2019,29,"Scotland",39175,39140,78315
"1425",2019,30,"Scotland",39082,38692,77774
"1426",2019,31,"Scotland",39310,38454,77764
"1427",2019,32,"Scotland",38196,37013,75209
"1428",2019,33,"Scotland",37436,36988,74424
"1429",2019,34,"Scotland",37718,36186,73904
"1430",2019,35,"Scotland",36399,35008,71407
"1431",2019,36,"Scotland",36912,35337,72249
"1432",2019,37,"Scotland",37409,35458,72867
"1433",2019,38,"Scotland",36952,35646,72598
"1434",2019,39,"Scotland",36171,35115,71286
"1435",2019,40,"Scotland",34440,34033,68473
"1436",2019,41,"Scotland",32536,30914,63450
"1437",2019,42,"Scotland",31363,30923,62286
"1438",2019,43,"Scotland",33375,31960,65335
"1439",2019,44,"Scotland",33743,31850,65593
"1440",2019,45,"Scotland",34043,32735,66778
"1441",2019,46,"Scotland",36215,34624,70839
"1442",2019,47,"Scotland",38807,36183,74990
"1443",2019,48,"Scotland",40684,37364,78048
"1444",2019,49,"Scotland",39838,36870,76708
"1445",2019,50,"Scotland",41306,38352,79658
"1446",2019,51,"Scotland",42010,38904,80914
"1447",2019,52,"Scotland",41788,39685,81473
"1448",2019,53,"Scotland",41718,39080,80798
"1449",2019,54,"Scotland",42967,40566,83533
"1450",2019,55,"Scotland",42861,39717,82578
"1451",2019,56,"Scotland",42331,39677,82008
"1452",2019,57,"Scotland",41069,38983,80052
"1453",2019,58,"Scotland",40038,37911,77949
"1454",2019,59,"Scotland",38559,36551,75110
"1455",2019,60,"Scotland",38327,35829,74156
"1456",2019,61,"Scotland",37308,34929,72237
"1457",2019,62,"Scotland",35879,33993,69872
"1458",2019,63,"Scotland",34772,32668,67440
"1459",2019,64,"Scotland",33240,30902,64142
"1460",2019,65,"Scotland",32525,30652,63177
"1461",2019,66,"Scotland",31921,29695,61616
"1462",2019,67,"Scotland",30637,28597,59234
"1463",2019,68,"Scotland",30747,28491,59238
"1464",2019,69,"Scotland",30742,28522,59264
"1465",2019,70,"Scotland",31247,28850,60097
"1466",2019,71,"Scotland",32186,29362,61548
"1467",2019,72,"Scotland",34553,31159,65712
"1468",2019,73,"Scotland",25804,23197,49001
"1469",2019,74,"Scotland",24557,21363,45920
"1470",2019,75,"Scotland",24483,21349,45832
"1471",2019,76,"Scotland",23565,19433,42998
"1472",2019,77,"Scotland",21644,17298,38942
"1473",2019,78,"Scotland",19779,15476,35255
"1474",2019,79,"Scotland",19651,15365,35016
"1475",2019,80,"Scotland",18887,14391,33278
"1476",2019,81,"Scotland",17985,13493,31478
"1477",2019,82,"Scotland",16792,11888,28680
"1478",2019,83,"Scotland",15747,10787,26534
"1479",2019,84,"Scotland",14359,9792,24151
"1480",2019,85,"Scotland",12976,8391,21367
"1481",2019,86,"Scotland",11510,7406,18916
"1482",2019,87,"Scotland",10625,6474,17099
"1483",2019,88,"Scotland",9282,5362,14644
"1484",2019,89,"Scotland",7935,4205,12140
"1485",2019,90,"Scotland",5480,2690,8170
"1486",2020,0,"Scotland",24362,25576,49938
"1487",2020,1,"Scotland",25426,27039,52465
"1488",2020,2,"Scotland",26403,27825,54228
"1489",2020,3,"Scotland",26947,28885,55832
"1490",2020,4,"Scotland",28085,30054,58139
"1491",2020,5,"Scotland",28702,30320,59022
"1492",2020,6,"Scotland",28815,30411,59226
"1493",2020,7,"Scotland",29541,30955,60496
"1494",2020,8,"Scotland",30224,31901,62125
"1495",2020,9,"Scotland",31338,32722,64060
"1496",2020,10,"Scotland",30066,31039,61105
"1497",2020,11,"Scotland",30745,32010,62755
"1498",2020,12,"Scotland",30592,31759,62351
"1499",2020,13,"Scotland",29174,30688,59862
"1500",2020,14,"Scotland",28860,29992,58852
"1501",2020,15,"Scotland",28336,29919,58255
"1502",2020,16,"Scotland",27579,29361,56940
"1503",2020,17,"Scotland",27110,28348,55458
"1504",2020,18,"Scotland",27206,28499,55705
"1505",2020,19,"Scotland",30656,31178,61834
"1506",2020,20,"Scotland",32082,33096,65178
"1507",2020,21,"Scotland",33692,34518,68210
"1508",2020,22,"Scotland",34794,35710,70504
"1509",2020,23,"Scotland",36381,37326,73707
"1510",2020,24,"Scotland",35928,37180,73108
"1511",2020,25,"Scotland",35905,37009,72914
"1512",2020,26,"Scotland",37165,37728,74893
"1513",2020,27,"Scotland",38651,38215,76866
"1514",2020,28,"Scotland",40846,40354,81200
"1515",2020,29,"Scotland",40646,40835,81481
"1516",2020,30,"Scotland",39298,39298,78596
"1517",2020,31,"Scotland",39170,38726,77896
"1518",2020,32,"Scotland",39371,38431,77802
"1519",2020,33,"Scotland",38210,37055,75265
"1520",2020,34,"Scotland",37546,37043,74589
"1521",2020,35,"Scotland",37759,36262,74021
"1522",2020,36,"Scotland",36441,35132,71573
"1523",2020,37,"Scotland",36952,35361,72313
"1524",2020,38,"Scotland",37523,35598,73121
"1525",2020,39,"Scotland",37021,35759,72780
"1526",2020,40,"Scotland",36161,35080,71241
"1527",2020,41,"Scotland",34455,33942,68397
"1528",2020,42,"Scotland",32590,30895,63485
"1529",2020,43,"Scotland",31338,30861,62199
"1530",2020,44,"Scotland",33339,31923,65262
"1531",2020,45,"Scotland",33767,31739,65506
"1532",2020,46,"Scotland",34056,32655,66711
"1533",2020,47,"Scotland",36181,34554,70735
"1534",2020,48,"Scotland",38765,36078,74843
"1535",2020,49,"Scotland",40635,37205,77840
"1536",2020,50,"Scotland",39831,36714,76545
"1537",2020,51,"Scotland",41234,38195,79429
"1538",2020,52,"Scotland",41946,38743,80689
"1539",2020,53,"Scotland",41750,39497,81247
"1540",2020,54,"Scotland",41658,38890,80548
"1541",2020,55,"Scotland",42846,40278,83124
"1542",2020,56,"Scotland",42742,39504,82246
"1543",2020,57,"Scotland",42163,39423,81586
"1544",2020,58,"Scotland",40919,38796,79715
"1545",2020,59,"Scotland",39862,37598,77460
"1546",2020,60,"Scotland",38360,36219,74579
"1547",2020,61,"Scotland",38133,35521,73654
"1548",2020,62,"Scotland",37080,34530,71610
"1549",2020,63,"Scotland",35596,33637,69233
"1550",2020,64,"Scotland",34502,32304,66806
"1551",2020,65,"Scotland",32982,30467,63449
"1552",2020,66,"Scotland",32212,30180,62392
"1553",2020,67,"Scotland",31583,29211,60794
"1554",2020,68,"Scotland",30265,28066,58331
"1555",2020,69,"Scotland",30355,27916,58271
"1556",2020,70,"Scotland",30284,27909,58193
"1557",2020,71,"Scotland",30770,28161,58931
"1558",2020,72,"Scotland",31583,28632,60215
"1559",2020,73,"Scotland",33883,30237,64120
"1560",2020,74,"Scotland",25204,22441,47645
"1561",2020,75,"Scotland",23944,20501,44445
"1562",2020,76,"Scotland",23768,20451,44219
"1563",2020,77,"Scotland",22745,18589,41334
"1564",2020,78,"Scotland",20837,16337,37174
"1565",2020,79,"Scotland",18959,14499,33458
"1566",2020,80,"Scotland",18737,14309,33046
"1567",2020,81,"Scotland",17853,13361,31214
"1568",2020,82,"Scotland",16916,12438,29354
"1569",2020,83,"Scotland",15615,10864,26479
"1570",2020,84,"Scotland",14577,9722,24299
"1571",2020,85,"Scotland",13164,8775,21939
"1572",2020,86,"Scotland",11803,7383,19186
"1573",2020,87,"Scotland",10234,6389,16623
"1574",2020,88,"Scotland",9375,5526,14901
"1575",2020,89,"Scotland",8063,4504,12567
"1576",2020,90,"Scotland",5540,2900,8440
"1577",2013,91,"Scotland",5380,2320,7700
"1578",2013,92,"Scotland",4520,1780,6300
"1579",2013,93,"Scotland",3800,1380,5180
"1580",2013,94,"Scotland",1960,690,2650
"1581",2013,95,"Scotland",1500,450,1950
"1582",2013,96,"Scotland",1200,330,1530
"1583",2013,97,"Scotland",980,250,1230
"1584",2013,98,"Scotland",680,160,840
"1585",2013,99,"Scotland",480,110,590
"1586",2013,100,"Scotland",300,60,360
"1587",2013,101,"Scotland",190,30,220
"1588",2013,102,"Scotland",100,20,120
"1589",2013,103,"Scotland",50,10,60
"1590",2013,104,"Scotland",40,0,40
"1591",2013,105,"Scotland",30,0,30
"1592",2014,91,"Scotland",5280,2230,7510
"1593",2014,92,"Scotland",4530,1840,6370
"1594",2014,93,"Scotland",3720,1380,5100
"1595",2014,94,"Scotland",3100,1070,4170
"1596",2014,95,"Scotland",1530,510,2040
"1597",2014,96,"Scotland",1150,340,1490
"1598",2014,97,"Scotland",890,230,1120
"1599",2014,98,"Scotland",700,180,880
"1600",2014,99,"Scotland",490,120,610
"1601",2014,100,"Scotland",340,60,400
"1602",2014,101,"Scotland",200,30,230
"1603",2014,102,"Scotland",120,10,130
"1604",2014,103,"Scotland",60,10,70
"1605",2014,104,"Scotland",30,10,40
"1606",2014,105,"Scotland",40,0,40
"1607",2015,91,"Scotland",5280,2370,7650
"1608",2015,92,"Scotland",4300,1740,6040
"1609",2015,93,"Scotland",3540,1410,4950
"1610",2015,94,"Scotland",2920,1020,3940
"1611",2015,95,"Scotland",2340,770,3110
"1612",2015,96,"Scotland",1130,360,1490
"1613",2015,97,"Scotland",800,220,1020
"1614",2015,98,"Scotland",600,150,750
"1615",2015,99,"Scotland",450,110,560
"1616",2015,100,"Scotland",290,80,370
"1617",2015,101,"Scotland",210,40,250
"1618",2015,102,"Scotland",110,20,130
"1619",2015,103,"Scotland",60,10,70
"1620",2015,104,"Scotland",40,10,50
"1621",2015,105,"Scotland",30,0,30
"1622",2016,91,"Scotland",5340,2490,7830
"1623",2016,92,"Scotland",4360,1860,6220
"1624",2016,93,"Scotland",3460,1350,4810
"1625",2016,94,"Scotland",2760,1080,3840
"1626",2016,95,"Scotland",2280,760,3040
"1627",2016,96,"Scotland",1730,550,2280
"1628",2016,97,"Scotland",840,250,1090
"1629",2016,98,"Scotland",580,140,720
"1630",2016,99,"Scotland",420,110,530
"1631",2016,100,"Scotland",290,70,360
"1632",2016,101,"Scotland",180,50,230
"1633",2016,102,"Scotland",130,30,160
"1634",2016,103,"Scotland",60,10,70
"1635",2016,104,"Scotland",30,10,40
"1636",2016,105,"Scotland",30,10,40
"1637",2017,91,"Scotland",5480,2630,8110
"1638",2017,92,"Scotland",4380,1980,6360
"1639",2017,93,"Scotland",3510,1420,4930
"1640",2017,94,"Scotland",2710,1000,3710
"1641",2017,95,"Scotland",2090,790,2880
"1642",2017,96,"Scotland",1700,540,2240
"1643",2017,97,"Scotland",1230,360,1590
"1644",2017,98,"Scotland",570,170,740
"1645",2017,99,"Scotland",400,80,480
"1646",2017,100,"Scotland",270,60,330
"1647",2017,101,"Scotland",180,40,220
"1648",2017,102,"Scotland",110,30,140
"1649",2017,103,"Scotland",70,10,80
"1650",2017,104,"Scotland",30,0,30
"1651",2017,105,"Scotland",30,10,40
"1652",2018,91,"Scotland",5460,2610,8070
"1653",2018,92,"Scotland",4460,2060,6520
"1654",2018,93,"Scotland",3470,1510,4980
"1655",2018,94,"Scotland",2720,1040,3760
"1656",2018,95,"Scotland",2040,700,2740
"1657",2018,96,"Scotland",1550,550,2100
"1658",2018,97,"Scotland",1220,360,1580
"1659",2018,98,"Scotland",850,240,1090
"1660",2018,99,"Scotland",390,100,490
"1661",2018,100,"Scotland",250,50,300
"1662",2018,101,"Scotland",160,40,200
"1663",2018,102,"Scotland",110,20,130
"1664",2018,103,"Scotland",70,20,90
"1665",2018,104,"Scotland",40,0,40
"1666",2018,105,"Scotland",30,10,40
"1667",2019,91,"Scotland",5520,2700,8220
"1668",2019,92,"Scotland",4560,2070,6630
"1669",2019,93,"Scotland",3680,1590,5270
"1670",2019,94,"Scotland",2770,1150,3920
"1671",2019,95,"Scotland",2140,790,2930
"1672",2019,96,"Scotland",1580,500,2080
"1673",2019,97,"Scotland",1150,380,1530
"1674",2019,98,"Scotland",890,240,1130
"1675",2019,99,"Scotland",590,160,750
"1676",2019,100,"Scotland",270,70,340
"1677",2019,101,"Scotland",160,30,190
"1678",2019,102,"Scotland",100,20,120
"1679",2019,103,"Scotland",60,10,70
"1680",2019,104,"Scotland",40,10,50
"1681",2019,105,"Scotland",40,10,50
"1682",2020,91,"Scotland",5570,2910,8480
"1683",2020,92,"Scotland",4520,2090,6610
"1684",2020,93,"Scotland",3590,1570,5160
"1685",2020,94,"Scotland",2860,1190,4050
"1686",2020,95,"Scotland",2110,810,2920
"1687",2020,96,"Scotland",1570,550,2120
"1688",2020,97,"Scotland",1100,330,1430
"1689",2020,98,"Scotland",760,240,1000
"1690",2020,99,"Scotland",580,150,730
"1691",2020,100,"Scotland",350,100,450
"1692",2020,101,"Scotland",150,40,190
"1693",2020,102,"Scotland",90,20,110
"1694",2020,103,"Scotland",60,10,70
"1695",2020,104,"Scotland",30,10,40
"1696",2020,105,"Scotland",30,10,40
"1697",2013,0,"Wales",15237,16161,31398
"1698",2013,1,"Wales",15894,16713,32607
"1699",2013,2,"Wales",16324,17163,33487
"1700",2013,3,"Wales",16018,16851,32869
"1701",2013,4,"Wales",15735,16697,32432
"1702",2013,5,"Wales",16252,16958,33210
"1703",2013,6,"Wales",15728,16375,32103
"1704",2013,7,"Wales",15385,16275,31660
"1705",2013,8,"Wales",14807,15667,30474
"1706",2013,9,"Wales",14538,15230,29768
"1707",2013,10,"Wales",14132,14990,29122
"1708",2013,11,"Wales",14194,15112,29306
"1709",2013,12,"Wales",14693,15882,30575
"1710",2013,13,"Wales",15211,16140,31351
"1711",2013,14,"Wales",15783,16686,32469
"1712",2013,15,"Wales",16279,17015,33294
"1713",2013,16,"Wales",16813,17846,34659
"1714",2013,17,"Wales",16262,17634,33896
"1715",2013,18,"Wales",16837,17818,34655
"1716",2013,19,"Wales",19038,20401,39439
"1717",2013,20,"Wales",19966,20874,40840
"1718",2013,21,"Wales",20563,20687,41250
"1719",2013,22,"Wales",19898,21394,41292
"1720",2013,23,"Wales",18910,20102,39012
"1721",2013,24,"Wales",18376,19359,37735
"1722",2013,25,"Wales",17702,18691,36393
"1723",2013,26,"Wales",17151,17550,34701
"1724",2013,27,"Wales",16709,17533,34242
"1725",2013,28,"Wales",16838,17196,34034
"1726",2013,29,"Wales",16318,16569,32887
"1727",2013,30,"Wales",16518,16606,33124
"1728",2013,31,"Wales",16512,16368,32880
"1729",2013,32,"Wales",16779,16754,33533
"1730",2013,33,"Wales",16932,16882,33814
"1731",2013,34,"Wales",15892,16019,31911
"1732",2013,35,"Wales",14996,14539,29535
"1733",2013,36,"Wales",14828,14889,29717
"1734",2013,37,"Wales",15187,14895,30082
"1735",2013,38,"Wales",15684,15515,31199
"1736",2013,39,"Wales",16343,15897,32240
"1737",2013,40,"Wales",17506,16758,34264
"1738",2013,41,"Wales",18460,18128,36588
"1739",2013,42,"Wales",19649,18825,38474
"1740",2013,43,"Wales",19149,18365,37514
"1741",2013,44,"Wales",20147,19394,39541
"1742",2013,45,"Wales",19799,19026,38825
"1743",2013,46,"Wales",20446,19621,40067
"1744",2013,47,"Wales",20403,19678,40081
"1745",2013,48,"Wales",21006,20130,41136
"1746",2013,49,"Wales",21060,20177,41237
"1747",2013,50,"Wales",20393,19827,40220
"1748",2013,51,"Wales",20100,19660,39760
"1749",2013,52,"Wales",19820,19010,38830
"1750",2013,53,"Wales",19054,18512,37566
"1751",2013,54,"Wales",18815,18189,37004
"1752",2013,55,"Wales",18551,17823,36374
"1753",2013,56,"Wales",18151,17472,35623
"1754",2013,57,"Wales",17550,16735,34285
"1755",2013,58,"Wales",16976,16443,33419
"1756",2013,59,"Wales",17800,16972,34772
"1757",2013,60,"Wales",17768,16904,34672
"1758",2013,61,"Wales",17203,16631,33834
"1759",2013,62,"Wales",17674,16834,34508
"1760",2013,63,"Wales",18103,17570,35673
"1761",2013,64,"Wales",18639,17982,36621
"1762",2013,65,"Wales",19674,19099,38773
"1763",2013,66,"Wales",20962,20297,41259
"1764",2013,67,"Wales",16362,15497,31859
"1765",2013,68,"Wales",16094,15387,31481
"1766",2013,69,"Wales",16093,15455,31548
"1767",2013,70,"Wales",15179,14461,29640
"1768",2013,71,"Wales",14095,13085,27180
"1769",2013,72,"Wales",12974,11749,24723
"1770",2013,73,"Wales",12745,11733,24478
"1771",2013,74,"Wales",12491,11488,23979
"1772",2013,75,"Wales",12258,10936,23194
"1773",2013,76,"Wales",11620,10231,21851
"1774",2013,77,"Wales",11284,9605,20889
"1775",2013,78,"Wales",10683,9155,19838
"1776",2013,79,"Wales",10204,8139,18343
"1777",2013,80,"Wales",9806,7664,17470
"1778",2013,81,"Wales",9347,7073,16420
"1779",2013,82,"Wales",8783,6455,15238
"1780",2013,83,"Wales",8229,5830,14059
"1781",2013,84,"Wales",7602,5174,12776
"1782",2013,85,"Wales",6934,4476,11410
"1783",2013,86,"Wales",6504,3897,10401
"1784",2013,87,"Wales",5814,3463,9277
"1785",2013,88,"Wales",5306,2785,8091
"1786",2013,89,"Wales",4660,2398,7058
"1787",2013,90,"Wales",3890,1660,5550
"1788",2014,0,"Wales",14894,15784,30678
"1789",2014,1,"Wales",15390,16261,31651
"1790",2014,2,"Wales",15972,16783,32755
"1791",2014,3,"Wales",16405,17284,33689
"1792",2014,4,"Wales",16128,16955,33083
"1793",2014,5,"Wales",15809,16803,32612
"1794",2014,6,"Wales",16354,17018,33372
"1795",2014,7,"Wales",15787,16421,32208
"1796",2014,8,"Wales",15440,16346,31786
"1797",2014,9,"Wales",14865,15687,30552
"1798",2014,10,"Wales",14607,15286,29893
"1799",2014,11,"Wales",14202,15089,29291
"1800",2014,12,"Wales",14249,15178,29427
"1801",2014,13,"Wales",14740,15922,30662
"1802",2014,14,"Wales",15289,16212,31501
"1803",2014,15,"Wales",15855,16755,32610
"1804",2014,16,"Wales",16294,17062,33356
"1805",2014,17,"Wales",16914,17995,34909
"1806",2014,18,"Wales",16581,17975,34556
"1807",2014,19,"Wales",17868,19091,36959
"1808",2014,20,"Wales",19354,21242,40596
"1809",2014,21,"Wales",19605,20775,40380
"1810",2014,22,"Wales",19872,20375,40247
"1811",2014,23,"Wales",19453,20872,40325
"1812",2014,24,"Wales",18557,19634,38191
"1813",2014,25,"Wales",18060,19038,37098
"1814",2014,26,"Wales",17430,18437,35867
"1815",2014,27,"Wales",17024,17351,34375
"1816",2014,28,"Wales",16721,17321,34042
"1817",2014,29,"Wales",16802,17050,33852
"1818",2014,30,"Wales",16245,16428,32673
"1819",2014,31,"Wales",16455,16591,33046
"1820",2014,32,"Wales",16479,16285,32764
"1821",2014,33,"Wales",16802,16754,33556
"1822",2014,34,"Wales",16872,16769,33641
"1823",2014,35,"Wales",15895,16048,31943
"1824",2014,36,"Wales",15042,14573,29615
"1825",2014,37,"Wales",14852,14873,29725
"1826",2014,38,"Wales",15259,14892,30151
"1827",2014,39,"Wales",15718,15515,31233
"1828",2014,40,"Wales",16376,15877,32253
"1829",2014,41,"Wales",17526,16721,34247
"1830",2014,42,"Wales",18505,18147,36652
"1831",2014,43,"Wales",19651,18797,38448
"1832",2014,44,"Wales",19163,18391,37554
"1833",2014,45,"Wales",20139,19394,39533
"1834",2014,46,"Wales",19837,19052,38889
"1835",2014,47,"Wales",20446,19599,40045
"1836",2014,48,"Wales",20445,19716,40161
"1837",2014,49,"Wales",21041,20160,41201
"1838",2014,50,"Wales",21097,20148,41245
"1839",2014,51,"Wales",20406,19864,40270
"1840",2014,52,"Wales",20121,19693,39814
"1841",2014,53,"Wales",19853,19031,38884
"1842",2014,54,"Wales",19088,18509,37597
"1843",2014,55,"Wales",18900,18218,37118
"1844",2014,56,"Wales",18556,17827,36383
"1845",2014,57,"Wales",18150,17508,35658
"1846",2014,58,"Wales",17587,16672,34259
"1847",2014,59,"Wales",16981,16415,33396
"1848",2014,60,"Wales",17846,16903,34749
"1849",2014,61,"Wales",17732,16815,34547
"1850",2014,62,"Wales",17254,16591,33845
"1851",2014,63,"Wales",17645,16752,34397
"1852",2014,64,"Wales",18062,17450,35512
"1853",2014,65,"Wales",18573,17938,36511
"1854",2014,66,"Wales",19569,18986,38555
"1855",2014,67,"Wales",20828,20086,40914
"1856",2014,68,"Wales",16206,15323,31529
"1857",2014,69,"Wales",15908,15145,31053
"1858",2014,70,"Wales",15884,15160,31044
"1859",2014,71,"Wales",14937,14177,29114
"1860",2014,72,"Wales",13878,12781,26659
"1861",2014,73,"Wales",12756,11435,24191
"1862",2014,74,"Wales",12498,11407,23905
"1863",2014,75,"Wales",12247,11108,23355
"1864",2014,76,"Wales",11950,10571,22521
"1865",2014,77,"Wales",11294,9845,21139
"1866",2014,78,"Wales",10924,9219,20143
"1867",2014,79,"Wales",10366,8773,19139
"1868",2014,80,"Wales",9821,7703,17524
"1869",2014,81,"Wales",9413,7215,16628
"1870",2014,82,"Wales",8918,6609,15527
"1871",2014,83,"Wales",8318,5980,14298
"1872",2014,84,"Wales",7736,5343,13079
"1873",2014,85,"Wales",7051,4664,11715
"1874",2014,86,"Wales",6365,4004,10369
"1875",2014,87,"Wales",5965,3440,9405
"1876",2014,88,"Wales",5208,3020,8228
"1877",2014,89,"Wales",4711,2411,7122
"1878",2014,90,"Wales",3690,1620,5310
"1879",2015,0,"Wales",14899,15613,30512
"1880",2015,1,"Wales",15069,15909,30978
"1881",2015,2,"Wales",15557,16360,31917
"1882",2015,3,"Wales",16096,16871,32967
"1883",2015,4,"Wales",16516,17385,33901
"1884",2015,5,"Wales",16207,17089,33296
"1885",2015,6,"Wales",15926,16852,32778
"1886",2015,7,"Wales",16416,17127,33543
"1887",2015,8,"Wales",15825,16526,32351
"1888",2015,9,"Wales",15541,16411,31952
"1889",2015,10,"Wales",14950,15735,30685
"1890",2015,11,"Wales",14674,15286,29960
"1891",2015,12,"Wales",14259,15184,29443
"1892",2015,13,"Wales",14324,15252,29576
"1893",2015,14,"Wales",14760,16012,30772
"1894",2015,15,"Wales",15346,16305,31651
"1895",2015,16,"Wales",15927,16830,32757
"1896",2015,17,"Wales",16354,17168,33522
"1897",2015,18,"Wales",17201,18232,35433
"1898",2015,19,"Wales",17637,19316,36953
"1899",2015,20,"Wales",18298,19771,38069
"1900",2015,21,"Wales",19183,21184,40367
"1901",2015,22,"Wales",19110,20287,39397
"1902",2015,23,"Wales",19363,19903,39266
"1903",2015,24,"Wales",19088,20457,39545
"1904",2015,25,"Wales",18241,19361,37602
"1905",2015,26,"Wales",17936,18712,36648
"1906",2015,27,"Wales",17326,18248,35574
"1907",2015,28,"Wales",16987,17240,34227
"1908",2015,29,"Wales",16737,17103,33840
"1909",2015,30,"Wales",16892,16938,33830
"1910",2015,31,"Wales",16234,16393,32627
"1911",2015,32,"Wales",16462,16503,32965
"1912",2015,33,"Wales",16465,16249,32714
"1913",2015,34,"Wales",16885,16746,33631
"1914",2015,35,"Wales",16878,16684,33562
"1915",2015,36,"Wales",15924,16037,31961
"1916",2015,37,"Wales",15111,14591,29702
"1917",2015,38,"Wales",14866,14901,29767
"1918",2015,39,"Wales",15270,14805,30075
"1919",2015,40,"Wales",15773,15441,31214
"1920",2015,41,"Wales",16415,15876,32291
"1921",2015,42,"Wales",17597,16721,34318
"1922",2015,43,"Wales",18580,18153,36733
"1923",2015,44,"Wales",19662,18869,38531
"1924",2015,45,"Wales",19218,18385,37603
"1925",2015,46,"Wales",20190,19343,39533
"1926",2015,47,"Wales",19905,19084,38989
"1927",2015,48,"Wales",20437,19632,40069
"1928",2015,49,"Wales",20548,19722,40270
"1929",2015,50,"Wales",21129,20167,41296
"1930",2015,51,"Wales",21109,20141,41250
"1931",2015,52,"Wales",20485,19859,40344
"1932",2015,53,"Wales",20205,19741,39946
"1933",2015,54,"Wales",19851,19009,38860
"1934",2015,55,"Wales",19139,18497,37636
"1935",2015,56,"Wales",18923,18241,37164
"1936",2015,57,"Wales",18622,17818,36440
"1937",2015,58,"Wales",18214,17492,35706
"1938",2015,59,"Wales",17618,16644,34262
"1939",2015,60,"Wales",17012,16348,33360
"1940",2015,61,"Wales",17759,16873,34632
"1941",2015,62,"Wales",17725,16771,34496
"1942",2015,63,"Wales",17209,16515,33724
"1943",2015,64,"Wales",17597,16679,34276
"1944",2015,65,"Wales",17952,17370,35322
"1945",2015,66,"Wales",18447,17800,36247
"1946",2015,67,"Wales",19427,18762,38189
"1947",2015,68,"Wales",20632,19849,40481
"1948",2015,69,"Wales",16028,15081,31109
"1949",2015,70,"Wales",15724,14893,30617
"1950",2015,71,"Wales",15588,14845,30433
"1951",2015,72,"Wales",14677,13861,28538
"1952",2015,73,"Wales",13608,12444,26052
"1953",2015,74,"Wales",12469,11090,23559
"1954",2015,75,"Wales",12202,11035,23237
"1955",2015,76,"Wales",11931,10706,22637
"1956",2015,77,"Wales",11568,10088,21656
"1957",2015,78,"Wales",10971,9372,20343
"1958",2015,79,"Wales",10521,8714,19235
"1959",2015,80,"Wales",9939,8252,18191
"1960",2015,81,"Wales",9374,7214,16588
"1961",2015,82,"Wales",8938,6723,15661
"1962",2015,83,"Wales",8368,6089,14457
"1963",2015,84,"Wales",7738,5478,13216
"1964",2015,85,"Wales",7141,4829,11970
"1965",2015,86,"Wales",6432,4096,10528
"1966",2015,87,"Wales",5734,3498,9232
"1967",2015,88,"Wales",5341,2963,8304
"1968",2015,89,"Wales",4530,2561,7091
"1969",2015,90,"Wales",3610,1770,5380
"1970",2016,0,"Wales",14877,15520,30397
"1971",2016,1,"Wales",15015,15776,30791
"1972",2016,2,"Wales",15189,16118,31307
"1973",2016,3,"Wales",15683,16456,32139
"1974",2016,4,"Wales",16236,16993,33229
"1975",2016,5,"Wales",16610,17464,34074
"1976",2016,6,"Wales",16277,17174,33451
"1977",2016,7,"Wales",16024,16907,32931
"1978",2016,8,"Wales",16479,17182,33661
"1979",2016,9,"Wales",15869,16607,32476
"1980",2016,10,"Wales",15642,16504,32146
"1981",2016,11,"Wales",15040,15805,30845
"1982",2016,12,"Wales",14747,15374,30121
"1983",2016,13,"Wales",14337,15275,29612
"1984",2016,14,"Wales",14373,15302,29675
"1985",2016,15,"Wales",14808,16171,30979
"1986",2016,16,"Wales",15400,16430,31830
"1987",2016,17,"Wales",15949,16908,32857
"1988",2016,18,"Wales",16586,17493,34079
"1989",2016,19,"Wales",17962,19285,37247
"1990",2016,20,"Wales",18129,20262,38391
"1991",2016,21,"Wales",18119,20015,38134
"1992",2016,22,"Wales",18849,21039,39888
"1993",2016,23,"Wales",18899,19913,38812
"1994",2016,24,"Wales",19110,19685,38795
"1995",2016,25,"Wales",18923,20247,39170
"1996",2016,26,"Wales",18110,19329,37439
"1997",2016,27,"Wales",17932,18693,36625
"1998",2016,28,"Wales",17365,18255,35620
"1999",2016,29,"Wales",16953,17274,34227
"2000",2016,30,"Wales",16825,17180,34005
"2001",2016,31,"Wales",16974,16983,33957
"2002",2016,32,"Wales",16299,16461,32760
"2003",2016,33,"Wales",16535,16499,33034
"2004",2016,34,"Wales",16471,16296,32767
"2005",2016,35,"Wales",16996,16835,33831
"2006",2016,36,"Wales",16947,16785,33732
"2007",2016,37,"Wales",15959,16099,32058
"2008",2016,38,"Wales",15203,14622,29825
"2009",2016,39,"Wales",14906,14887,29793
"2010",2016,40,"Wales",15344,14821,30165
"2011",2016,41,"Wales",15831,15440,31271
"2012",2016,42,"Wales",16508,15972,32480
"2013",2016,43,"Wales",17643,16765,34408
"2014",2016,44,"Wales",18613,18191,36804
"2015",2016,45,"Wales",19778,18952,38730
"2016",2016,46,"Wales",19277,18421,37698
"2017",2016,47,"Wales",20270,19397,39667
"2018",2016,48,"Wales",19978,19174,39152
"2019",2016,49,"Wales",20533,19599,40132
"2020",2016,50,"Wales",20639,19714,40353
"2021",2016,51,"Wales",21143,20237,41380
"2022",2016,52,"Wales",21197,20225,41422
"2023",2016,53,"Wales",20584,19930,40514
"2024",2016,54,"Wales",20236,19727,39963
"2025",2016,55,"Wales",19911,19022,38933
"2026",2016,56,"Wales",19176,18459,37635
"2027",2016,57,"Wales",19031,18260,37291
"2028",2016,58,"Wales",18672,17861,36533
"2029",2016,59,"Wales",18239,17497,35736
"2030",2016,60,"Wales",17702,16622,34324
"2031",2016,61,"Wales",17031,16352,33383
"2032",2016,62,"Wales",17792,16844,34636
"2033",2016,63,"Wales",17673,16713,34386
"2034",2016,64,"Wales",17185,16427,33612
"2035",2016,65,"Wales",17548,16567,34115
"2036",2016,66,"Wales",17849,17231,35080
"2037",2016,67,"Wales",18296,17668,35964
"2038",2016,68,"Wales",19246,18565,37811
"2039",2016,69,"Wales",20483,19617,40100
"2040",2016,70,"Wales",15846,14755,30601
"2041",2016,71,"Wales",15486,14573,30059
"2042",2016,72,"Wales",15357,14496,29853
"2043",2016,73,"Wales",14418,13497,27915
"2044",2016,74,"Wales",13331,12073,25404
"2045",2016,75,"Wales",12167,10680,22847
"2046",2016,76,"Wales",11888,10667,22555
"2047",2016,77,"Wales",11617,10291,21908
"2048",2016,78,"Wales",11216,9625,20841
"2049",2016,79,"Wales",10623,8897,19520
"2050",2016,80,"Wales",10087,8253,18340
"2051",2016,81,"Wales",9487,7770,17257
"2052",2016,82,"Wales",8942,6766,15708
"2053",2016,83,"Wales",8430,6259,14689
"2054",2016,84,"Wales",7809,5568,13377
"2055",2016,85,"Wales",7200,4970,12170
"2056",2016,86,"Wales",6541,4366,10907
"2057",2016,87,"Wales",5820,3613,9433
"2058",2016,88,"Wales",5145,3009,8154
"2059",2016,89,"Wales",4694,2547,7241
"2060",2016,90,"Wales",3710,1770,5480
"2061",2017,0,"Wales",14497,15010,29507
"2062",2017,1,"Wales",15069,15750,30819
"2063",2017,2,"Wales",15151,15882,31033
"2064",2017,3,"Wales",15307,16261,31568
"2065",2017,4,"Wales",15811,16602,32413
"2066",2017,5,"Wales",16356,17093,33449
"2067",2017,6,"Wales",16673,17584,34257
"2068",2017,7,"Wales",16349,17265,33614
"2069",2017,8,"Wales",16074,17030,33104
"2070",2017,9,"Wales",16520,17297,33817
"2071",2017,10,"Wales",15943,16706,32649
"2072",2017,11,"Wales",15711,16596,32307
"2073",2017,12,"Wales",15096,15870,30966
"2074",2017,13,"Wales",14802,15500,30302
"2075",2017,14,"Wales",14351,15355,29706
"2076",2017,15,"Wales",14430,15427,29857
"2077",2017,16,"Wales",14848,16253,31101
"2078",2017,17,"Wales",15424,16511,31935
"2079",2017,18,"Wales",16161,17256,33417
"2080",2017,19,"Wales",17634,18897,36531
"2081",2017,20,"Wales",18316,19956,38272
"2082",2017,21,"Wales",17935,20149,38084
"2083",2017,22,"Wales",17606,19648,37254
"2084",2017,23,"Wales",18424,20642,39066
"2085",2017,24,"Wales",18561,19542,38103
"2086",2017,25,"Wales",18887,19458,38345
"2087",2017,26,"Wales",18759,20073,38832
"2088",2017,27,"Wales",18112,19014,37126
"2089",2017,28,"Wales",17953,18521,36474
"2090",2017,29,"Wales",17391,18134,35525
"2091",2017,30,"Wales",16961,17134,34095
"2092",2017,31,"Wales",16880,17107,33987
"2093",2017,32,"Wales",17057,17017,34074
"2094",2017,33,"Wales",16380,16428,32808
"2095",2017,34,"Wales",16685,16476,33161
"2096",2017,35,"Wales",16543,16321,32864
"2097",2017,36,"Wales",17132,16836,33968
"2098",2017,37,"Wales",17014,16839,33853
"2099",2017,38,"Wales",16030,16101,32131
"2100",2017,39,"Wales",15314,14629,29943
"2101",2017,40,"Wales",14953,14896,29849
"2102",2017,41,"Wales",15414,14863,30277
"2103",2017,42,"Wales",15882,15504,31386
"2104",2017,43,"Wales",16566,15951,32517
"2105",2017,44,"Wales",17729,16776,34505
"2106",2017,45,"Wales",18718,18201,36919
"2107",2017,46,"Wales",19876,18994,38870
"2108",2017,47,"Wales",19381,18519,37900
"2109",2017,48,"Wales",20328,19424,39752
"2110",2017,49,"Wales",20031,19174,39205
"2111",2017,50,"Wales",20602,19647,40249
"2112",2017,51,"Wales",20711,19746,40457
"2113",2017,52,"Wales",21249,20300,41549
"2114",2017,53,"Wales",21244,20216,41460
"2115",2017,54,"Wales",20701,19905,40606
"2116",2017,55,"Wales",20332,19766,40098
"2117",2017,56,"Wales",20009,18992,39001
"2118",2017,57,"Wales",19265,18427,37692
"2119",2017,58,"Wales",19097,18241,37338
"2120",2017,59,"Wales",18750,17881,36631
"2121",2017,60,"Wales",18294,17510,35804
"2122",2017,61,"Wales",17715,16610,34325
"2123",2017,62,"Wales",17029,16361,33390
"2124",2017,63,"Wales",17776,16768,34544
"2125",2017,64,"Wales",17632,16661,34293
"2126",2017,65,"Wales",17114,16378,33492
"2127",2017,66,"Wales",17431,16386,33817
"2128",2017,67,"Wales",17754,17063,34817
"2129",2017,68,"Wales",18150,17470,35620
"2130",2017,69,"Wales",19044,18331,37375
"2131",2017,70,"Wales",20255,19301,39556
"2132",2017,71,"Wales",15633,14468,30101
"2133",2017,72,"Wales",15233,14262,29495
"2134",2017,73,"Wales",15127,14142,29269
"2135",2017,74,"Wales",14146,13134,27280
"2136",2017,75,"Wales",13048,11665,24713
"2137",2017,76,"Wales",11863,10315,22178
"2138",2017,77,"Wales",11538,10253,21791
"2139",2017,78,"Wales",11200,9830,21030
"2140",2017,79,"Wales",10781,9163,19944
"2141",2017,80,"Wales",10245,8406,18651
"2142",2017,81,"Wales",9631,7737,17368
"2143",2017,82,"Wales",8993,7225,16218
"2144",2017,83,"Wales",8442,6251,14693
"2145",2017,84,"Wales",7881,5728,13609
"2146",2017,85,"Wales",7248,5013,12261
"2147",2017,86,"Wales",6652,4414,11066
"2148",2017,87,"Wales",5911,3864,9775
"2149",2017,88,"Wales",5289,3173,8462
"2150",2017,89,"Wales",4547,2563,7110
"2151",2017,90,"Wales",3530,1820,5350
"2152",2018,0,"Wales",14185,14882,29067
"2153",2018,1,"Wales",14675,15222,29897
"2154",2018,2,"Wales",15256,15944,31200
"2155",2018,3,"Wales",15296,16065,31361
"2156",2018,4,"Wales",15477,16438,31915
"2157",2018,5,"Wales",15919,16753,32672
"2158",2018,6,"Wales",16442,17261,33703
"2159",2018,7,"Wales",16764,17732,34496
"2160",2018,8,"Wales",16511,17338,33849
"2161",2018,9,"Wales",16194,17182,33376
"2162",2018,10,"Wales",16609,17395,34004
"2163",2018,11,"Wales",16013,16810,32823
"2164",2018,12,"Wales",15820,16665,32485
"2165",2018,13,"Wales",15191,15979,31170
"2166",2018,14,"Wales",14876,15655,30531
"2167",2018,15,"Wales",14435,15485,29920
"2168",2018,16,"Wales",14491,15512,30003
"2169",2018,17,"Wales",14934,16339,31273
"2170",2018,18,"Wales",15637,16806,32443
"2171",2018,19,"Wales",17061,18683,35744
"2172",2018,20,"Wales",18170,19504,37674
"2173",2018,21,"Wales",18159,20097,38256
"2174",2018,22,"Wales",17549,19966,37515
"2175",2018,23,"Wales",17293,19166,36459
"2176",2018,24,"Wales",18184,20374,38558
"2177",2018,25,"Wales",18414,19465,37879
"2178",2018,26,"Wales",18835,19285,38120
"2179",2018,27,"Wales",18827,19900,38727
"2180",2018,28,"Wales",18017,18819,36836
"2181",2018,29,"Wales",18004,18435,36439
"2182",2018,30,"Wales",17508,18001,35509
"2183",2018,31,"Wales",17123,17026,34149
"2184",2018,32,"Wales",17044,17228,34272
"2185",2018,33,"Wales",17199,17067,34266
"2186",2018,34,"Wales",16469,16438,32907
"2187",2018,35,"Wales",16741,16401,33142
"2188",2018,36,"Wales",16624,16345,32969
"2189",2018,37,"Wales",17333,16902,34235
"2190",2018,38,"Wales",17087,16878,33965
"2191",2018,39,"Wales",16112,16135,32247
"2192",2018,40,"Wales",15354,14625,29979
"2193",2018,41,"Wales",14998,14935,29933
"2194",2018,42,"Wales",15497,14910,30407
"2195",2018,43,"Wales",15915,15598,31513
"2196",2018,44,"Wales",16608,16021,32629
"2197",2018,45,"Wales",17852,16815,34667
"2198",2018,46,"Wales",18776,18233,37009
"2199",2018,47,"Wales",19978,19054,39032
"2200",2018,48,"Wales",19487,18522,38009
"2201",2018,49,"Wales",20393,19474,39867
"2202",2018,50,"Wales",20139,19238,39377
"2203",2018,51,"Wales",20712,19646,40358
"2204",2018,52,"Wales",20848,19804,40652
"2205",2018,53,"Wales",21385,20352,41737
"2206",2018,54,"Wales",21351,20305,41656
"2207",2018,55,"Wales",20855,19896,40751
"2208",2018,56,"Wales",20460,19848,40308
"2209",2018,57,"Wales",20129,19009,39138
"2210",2018,58,"Wales",19328,18456,37784
"2211",2018,59,"Wales",19167,18285,37452
"2212",2018,60,"Wales",18810,17904,36714
"2213",2018,61,"Wales",18349,17516,35865
"2214",2018,62,"Wales",17714,16620,34334
"2215",2018,63,"Wales",17004,16339,33343
"2216",2018,64,"Wales",17786,16719,34505
"2217",2018,65,"Wales",17562,16611,34173
"2218",2018,66,"Wales",17016,16271,33287
"2219",2018,67,"Wales",17333,16241,33574
"2220",2018,68,"Wales",17569,16874,34443
"2221",2018,69,"Wales",17993,17229,35222
"2222",2018,70,"Wales",18828,18043,36871
"2223",2018,71,"Wales",19947,18981,38928
"2224",2018,72,"Wales",15387,14140,29527
"2225",2018,73,"Wales",14958,13916,28874
"2226",2018,74,"Wales",14800,13756,28556
"2227",2018,75,"Wales",13808,12738,26546
"2228",2018,76,"Wales",12712,11247,23959
"2229",2018,77,"Wales",11523,9897,21420
"2230",2018,78,"Wales",11154,9811,20965
"2231",2018,79,"Wales",10786,9377,20163
"2232",2018,80,"Wales",10334,8660,18994
"2233",2018,81,"Wales",9841,7864,17705
"2234",2018,82,"Wales",9207,7202,16409
"2235",2018,83,"Wales",8501,6622,15123
"2236",2018,84,"Wales",7851,5671,13522
"2237",2018,85,"Wales",7305,5157,12462
"2238",2018,86,"Wales",6668,4457,11125
"2239",2018,87,"Wales",6039,3902,9941
"2240",2018,88,"Wales",5306,3339,8645
"2241",2018,89,"Wales",4620,2664,7284
"2242",2018,90,"Wales",3590,1870,5460
"2243",2019,0,"Wales",13406,14328,27734
"2244",2019,1,"Wales",14333,15068,29401
"2245",2019,2,"Wales",14749,15415,30164
"2246",2019,3,"Wales",15379,16072,31451
"2247",2019,4,"Wales",15378,16204,31582
"2248",2019,5,"Wales",15587,16522,32109
"2249",2019,6,"Wales",16014,16842,32856
"2250",2019,7,"Wales",16521,17384,33905
"2251",2019,8,"Wales",16812,17842,34654
"2252",2019,9,"Wales",16585,17419,34004
"2253",2019,10,"Wales",16240,17225,33465
"2254",2019,11,"Wales",16674,17503,34177
"2255",2019,12,"Wales",16102,16883,32985
"2256",2019,13,"Wales",15908,16747,32655
"2257",2019,14,"Wales",15265,16057,31322
"2258",2019,15,"Wales",14960,15809,30769
"2259",2019,16,"Wales",14531,15594,30125
"2260",2019,17,"Wales",14553,15620,30173
"2261",2019,18,"Wales",15200,16696,31896
"2262",2019,19,"Wales",16691,18197,34888
"2263",2019,20,"Wales",17583,19496,37079
"2264",2019,21,"Wales",18126,19642,37768
"2265",2019,22,"Wales",17867,19906,37773
"2266",2019,23,"Wales",17397,19658,37055
"2267",2019,24,"Wales",17072,18872,35944
"2268",2019,25,"Wales",18203,20214,38417
"2269",2019,26,"Wales",18407,19345,37752
"2270",2019,27,"Wales",18891,19242,38133
"2271",2019,28,"Wales",18816,19806,38622
"2272",2019,29,"Wales",18061,18805,36866
"2273",2019,30,"Wales",18130,18362,36492
"2274",2019,31,"Wales",17658,17908,35566
"2275",2019,32,"Wales",17224,17063,34287
"2276",2019,33,"Wales",17165,17162,34327
"2277",2019,34,"Wales",17290,17102,34392
"2278",2019,35,"Wales",16553,16476,33029
"2279",2019,36,"Wales",16913,16488,33401
"2280",2019,37,"Wales",16735,16347,33082
"2281",2019,38,"Wales",17361,16866,34227
"2282",2019,39,"Wales",17198,16892,34090
"2283",2019,40,"Wales",16161,16204,32365
"2284",2019,41,"Wales",15346,14610,29956
"2285",2019,42,"Wales",15101,14903,30004
"2286",2019,43,"Wales",15544,14933,30477
"2287",2019,44,"Wales",15983,15594,31577
"2288",2019,45,"Wales",16633,16058,32691
"2289",2019,46,"Wales",17911,16838,34749
"2290",2019,47,"Wales",18857,18272,37129
"2291",2019,48,"Wales",20055,19118,39173
"2292",2019,49,"Wales",19562,18532,38094
"2293",2019,50,"Wales",20552,19519,40071
"2294",2019,51,"Wales",20252,19273,39525
"2295",2019,52,"Wales",20765,19709,40474
"2296",2019,53,"Wales",20951,19861,40812
"2297",2019,54,"Wales",21522,20419,41941
"2298",2019,55,"Wales",21447,20337,41784
"2299",2019,56,"Wales",20958,19934,40892
"2300",2019,57,"Wales",20573,19866,40439
"2301",2019,58,"Wales",20250,19006,39256
"2302",2019,59,"Wales",19382,18476,37858
"2303",2019,60,"Wales",19175,18280,37455
"2304",2019,61,"Wales",18878,17959,36837
"2305",2019,62,"Wales",18353,17464,35817
"2306",2019,63,"Wales",17722,16591,34313
"2307",2019,64,"Wales",16981,16305,33286
"2308",2019,65,"Wales",17757,16632,34389
"2309",2019,66,"Wales",17464,16556,34020
"2310",2019,67,"Wales",16923,16091,33014
"2311",2019,68,"Wales",17201,16048,33249
"2312",2019,69,"Wales",17375,16634,34009
"2313",2019,70,"Wales",17773,16943,34716
"2314",2019,71,"Wales",18531,17756,36287
"2315",2019,72,"Wales",19643,18575,38218
"2316",2019,73,"Wales",15170,13809,28979
"2317",2019,74,"Wales",14710,13543,28253
"2318",2019,75,"Wales",14522,13326,27848
"2319",2019,76,"Wales",13466,12325,25791
"2320",2019,77,"Wales",12377,10817,23194
"2321",2019,78,"Wales",11172,9486,20658
"2322",2019,79,"Wales",10747,9368,20115
"2323",2019,80,"Wales",10393,8858,19251
"2324",2019,81,"Wales",9872,8134,18006
"2325",2019,82,"Wales",9372,7321,16693
"2326",2019,83,"Wales",8711,6697,15408
"2327",2019,84,"Wales",8000,6054,14054
"2328",2019,85,"Wales",7308,5133,12441
"2329",2019,86,"Wales",6725,4604,11329
"2330",2019,87,"Wales",6115,3934,10049
"2331",2019,88,"Wales",5456,3429,8885
"2332",2019,89,"Wales",4738,2885,7623
"2333",2019,90,"Wales",3400,1840,5240
"2334",2020,0,"Wales",13126,13632,26758
"2335",2020,1,"Wales",13560,14452,28012
"2336",2020,2,"Wales",14494,15202,29696
"2337",2020,3,"Wales",14883,15566,30449
"2338",2020,4,"Wales",15500,16180,31680
"2339",2020,5,"Wales",15420,16327,31747
"2340",2020,6,"Wales",15676,16599,32275
"2341",2020,7,"Wales",16077,16915,32992
"2342",2020,8,"Wales",16556,17453,34009
"2343",2020,9,"Wales",16895,17945,34840
"2344",2020,10,"Wales",16669,17500,34169
"2345",2020,11,"Wales",16281,17314,33595
"2346",2020,12,"Wales",16744,17595,34339
"2347",2020,13,"Wales",16160,16945,33105
"2348",2020,14,"Wales",15969,16814,32783
"2349",2020,15,"Wales",15353,16161,31514
"2350",2020,16,"Wales",15008,15920,30928
"2351",2020,17,"Wales",14582,15669,30251
"2352",2020,18,"Wales",14841,16098,30939
"2353",2020,19,"Wales",16695,18518,35213
"2354",2020,20,"Wales",17788,19618,37406
"2355",2020,21,"Wales",18157,20214,38371
"2356",2020,22,"Wales",18300,20103,38403
"2357",2020,23,"Wales",18041,19962,38003
"2358",2020,24,"Wales",17406,19775,37181
"2359",2020,25,"Wales",17119,18961,36080
"2360",2020,26,"Wales",18258,20279,38537
"2361",2020,27,"Wales",18510,19376,37886
"2362",2020,28,"Wales",19059,19414,38473
"2363",2020,29,"Wales",18912,19797,38709
"2364",2020,30,"Wales",18150,18853,37003
"2365",2020,31,"Wales",18257,18430,36687
"2366",2020,32,"Wales",17766,17987,35753
"2367",2020,33,"Wales",17351,17177,34528
"2368",2020,34,"Wales",17266,17197,34463
"2369",2020,35,"Wales",17459,17087,34546
"2370",2020,36,"Wales",16587,16486,33073
"2371",2020,37,"Wales",17005,16512,33517
"2372",2020,38,"Wales",16796,16343,33139
"2373",2020,39,"Wales",17401,16954,34355
"2374",2020,40,"Wales",17248,16892,34140
"2375",2020,41,"Wales",16212,16157,32369
"2376",2020,42,"Wales",15392,14638,30030
"2377",2020,43,"Wales",15154,14939,30093
"2378",2020,44,"Wales",15549,14903,30452
"2379",2020,45,"Wales",16038,15606,31644
"2380",2020,46,"Wales",16651,16054,32705
"2381",2020,47,"Wales",17947,16843,34790
"2382",2020,48,"Wales",18930,18282,37212
"2383",2020,49,"Wales",20123,19140,39263
"2384",2020,50,"Wales",19639,18581,38220
"2385",2020,51,"Wales",20609,19539,40148
"2386",2020,52,"Wales",20326,19282,39608
"2387",2020,53,"Wales",20813,19760,40573
"2388",2020,54,"Wales",21034,19930,40964
"2389",2020,55,"Wales",21595,20450,42045
"2390",2020,56,"Wales",21513,20368,41881
"2391",2020,57,"Wales",21062,19958,41020
"2392",2020,58,"Wales",20620,19882,40502
"2393",2020,59,"Wales",20291,18985,39276
"2394",2020,60,"Wales",19444,18449,37893
"2395",2020,61,"Wales",19230,18237,37467
"2396",2020,62,"Wales",18884,17965,36849
"2397",2020,63,"Wales",18295,17411,35706
"2398",2020,64,"Wales",17687,16499,34186
"2399",2020,65,"Wales",16893,16222,33115
"2400",2020,66,"Wales",17642,16504,34146
"2401",2020,67,"Wales",17314,16390,33704
"2402",2020,68,"Wales",16815,15871,32686
"2403",2020,69,"Wales",17009,15753,32762
"2404",2020,70,"Wales",17162,16323,33485
"2405",2020,71,"Wales",17539,16658,34197
"2406",2020,72,"Wales",18214,17377,35591
"2407",2020,73,"Wales",19299,18127,37426
"2408",2020,74,"Wales",14875,13438,28313
"2409",2020,75,"Wales",14334,13103,27437
"2410",2020,76,"Wales",14172,12885,27057
"2411",2020,77,"Wales",13071,11837,24908
"2412",2020,78,"Wales",11956,10349,22305
"2413",2020,79,"Wales",10756,8958,19714
"2414",2020,80,"Wales",10322,8859,19181
"2415",2020,81,"Wales",9925,8332,18257
"2416",2020,82,"Wales",9385,7588,16973
"2417",2020,83,"Wales",8826,6749,15575
"2418",2020,84,"Wales",8168,6138,14306
"2419",2020,85,"Wales",7378,5442,12820
"2420",2020,86,"Wales",6721,4572,11293
"2421",2020,87,"Wales",6108,4077,10185
"2422",2020,88,"Wales",5511,3370,8881
"2423",2020,89,"Wales",4794,2922,7716
"2424",2020,90,"Wales",3600,1980,5580
"2425",2013,91,"Wales",3920,1660,5580
"2426",2013,92,"Wales",3390,1260,4650
"2427",2013,93,"Wales",2850,960,3810
"2428",2013,94,"Wales",1530,570,2100
"2429",2013,95,"Wales",1180,340,1520
"2430",2013,96,"Wales",930,240,1170
"2431",2013,97,"Wales",690,190,880
"2432",2013,98,"Wales",510,100,610
"2433",2013,99,"Wales",380,80,460
"2434",2013,100,"Wales",220,50,270
"2435",2013,101,"Wales",160,20,180
"2436",2013,102,"Wales",80,10,90
"2437",2013,103,"Wales",60,0,60
"2438",2013,104,"Wales",30,0,30
"2439",2013,105,"Wales",30,0,30
"2440",2014,91,"Wales",3730,1620,5350
"2441",2014,92,"Wales",3320,1300,4620
"2442",2014,93,"Wales",2810,950,3760
"2443",2014,94,"Wales",2280,740,3020
"2444",2014,95,"Wales",1230,420,1650
"2445",2014,96,"Wales",910,240,1150
"2446",2014,97,"Wales",690,170,860
"2447",2014,98,"Wales",490,140,630
"2448",2014,99,"Wales",370,60,430
"2449",2014,100,"Wales",270,50,320
"2450",2014,101,"Wales",140,40,180
"2451",2014,102,"Wales",110,10,120
"2452",2014,103,"Wales",60,0,60
"2453",2014,104,"Wales",30,0,30
"2454",2014,105,"Wales",40,0,40
"2455",2015,91,"Wales",3640,1770,5410
"2456",2015,92,"Wales",3060,1280,4340
"2457",2015,93,"Wales",2650,1020,3670
"2458",2015,94,"Wales",2200,710,2910
"2459",2015,95,"Wales",1710,530,2240
"2460",2015,96,"Wales",910,310,1220
"2461",2015,97,"Wales",670,160,830
"2462",2015,98,"Wales",470,110,580
"2463",2015,99,"Wales",330,90,420
"2464",2015,100,"Wales",250,40,290
"2465",2015,101,"Wales",170,30,200
"2466",2015,102,"Wales",80,20,100
"2467",2015,103,"Wales",50,10,60
"2468",2015,104,"Wales",30,0,30
"2469",2015,105,"Wales",30,0,30
"2470",2016,91,"Wales",3750,1770,5520
"2471",2016,92,"Wales",3030,1420,4450
"2472",2016,93,"Wales",2520,1010,3530
"2473",2016,94,"Wales",2080,760,2840
"2474",2016,95,"Wales",1670,530,2200
"2475",2016,96,"Wales",1300,390,1690
"2476",2016,97,"Wales",670,210,880
"2477",2016,98,"Wales",480,110,590
"2478",2016,99,"Wales",330,70,400
"2479",2016,100,"Wales",220,60,280
"2480",2016,101,"Wales",160,20,180
"2481",2016,102,"Wales",100,20,120
"2482",2016,103,"Wales",50,10,60
"2483",2016,104,"Wales",30,0,30
"2484",2016,105,"Wales",40,0,40
"2485",2017,91,"Wales",3560,1820,5380
"2486",2017,92,"Wales",3110,1390,4500
"2487",2017,93,"Wales",2450,1100,3550
"2488",2017,94,"Wales",1980,740,2720
"2489",2017,95,"Wales",1610,530,2140
"2490",2017,96,"Wales",1250,370,1620
"2491",2017,97,"Wales",930,270,1200
"2492",2017,98,"Wales",480,140,620
"2493",2017,99,"Wales",310,70,380
"2494",2017,100,"Wales",190,40,230
"2495",2017,101,"Wales",130,30,160
"2496",2017,102,"Wales",100,20,120
"2497",2017,103,"Wales",50,10,60
"2498",2017,104,"Wales",20,0,20
"2499",2017,105,"Wales",30,0,30
"2500",2018,91,"Wales",3620,1870,5490
"2501",2018,92,"Wales",2920,1440,4360
"2502",2018,93,"Wales",2530,1070,3600
"2503",2018,94,"Wales",1920,800,2720
"2504",2018,95,"Wales",1530,570,2100
"2505",2018,96,"Wales",1170,380,1550
"2506",2018,97,"Wales",890,250,1140
"2507",2018,98,"Wales",660,180,840
"2508",2018,99,"Wales",310,90,400
"2509",2018,100,"Wales",210,40,250
"2510",2018,101,"Wales",120,30,150
"2511",2018,102,"Wales",90,20,110
"2512",2018,103,"Wales",60,0,60
"2513",2018,104,"Wales",30,0,30
"2514",2018,105,"Wales",30,0,30
"2515",2019,91,"Wales",3430,1840,5270
"2516",2019,92,"Wales",3060,1500,4560
"2517",2019,93,"Wales",2390,1130,3520
"2518",2019,94,"Wales",2040,800,2840
"2519",2019,95,"Wales",1490,590,2080
"2520",2019,96,"Wales",1170,410,1580
"2521",2019,97,"Wales",880,270,1150
"2522",2019,98,"Wales",660,170,830
"2523",2019,99,"Wales",460,130,590
"2524",2019,100,"Wales",210,60,270
"2525",2019,101,"Wales",130,20,150
"2526",2019,102,"Wales",80,20,100
"2527",2019,103,"Wales",60,10,70
"2528",2019,104,"Wales",30,0,30
"2529",2019,105,"Wales",30,0,30
"2530",2020,91,"Wales",3630,1980,5610
"2531",2020,92,"Wales",2840,1450,4290
"2532",2020,93,"Wales",2530,1120,3650
"2533",2020,94,"Wales",1910,820,2730
"2534",2020,95,"Wales",1570,590,2160
"2535",2020,96,"Wales",1120,420,1540
"2536",2020,97,"Wales",850,270,1120
"2537",2020,98,"Wales",620,180,800
"2538",2020,99,"Wales",440,110,550
"2539",2020,100,"Wales",300,70,370
"2540",2020,101,"Wales",140,30,170
"2541",2020,102,"Wales",80,10,90
"2542",2020,103,"Wales",50,10,60
"2543",2020,104,"Wales",30,10,40
"2544",2020,105,"Wales",30,0,30
